border_size=1
usage=map

Mm          , Mm          , Mm          , Mm          , Mm          , Mm          , Mm          , Mm          , Mm          , Mm          , Mm          , Mm          , Mm          , Mm          , Mm^Vhh      , Ms          , Mm          , Mm          , Mm          , Mm          , Mm          , Mm          , Mm          , Mm          , Mm          , Mm          , Mm          , Mm          , Mm^Vhh      , Mm          , Mm          , Ww          , Mm          , Mm          , Mm          , Mm          , Mm          , Mm          , Mm          , Mm          
Mm          , Mm^Vhh      , Mm          , Mm          , Mm          , Mm          , Mm          , Mm^Vhh      , Mm          , Mm          , Mm          , Mm          , Mm          , Mm          , Mm          , Mm          , Mm          , Mm          , Mm          , Mm          , Mm          , Mm          , Mm          , Mm          , Hh^Fms      , Mm          , Hh^Fms      , Mm          , Mm          , Mm          , Hh^Fms      , Ww          , Ww          , Hh^Fds      , Hh^Fds      , Mm          , Hh^Fds      , Mm          , Hh^Fds      , Mm          
Hh^Fms      , Mm          , Hh^Fms      , Mm          , Hh^Fms      , Mm          , Mm          , Mm          , Hh^Fdf      , Hh^Fds      , Hh^Fds      , Hh^Fds      , Hh          , Mm          , Hh          , Mm          , Hh          , Hh          , Hh          , Hh^Fds      , Hh^Fds      , Hh^Fds      , Hh^Fms      , Hh^Fms      , Ww          , Ww          , Ww          , Ww          , Ww          , Ww          , Ww          , Gg          , Gs^Fds      , Ww          , Ww          , Hh^Fds      , Hh^Fds      , Hh^Fds      , Hh^Fp       , Hh^Fds      
Hh^Fdw      , Hh^Fms      , Hh          , Hh^Fdw      , Hh^Fms      , Hh          , Hh^Fds      , Hh^Fds      , Hh          , Hh^Fds      , Hh^Fdf      , Hh^Fds      , Hh^Fdf      , Hh^Fdf      , Hh^Fdw      , Hh^Fds      , Hh^Fds      , Hh^Fds      , Hh          , Hh          , Gg          , Gg          , Ww          , Ww          , Ch          , Ch          , Ch          , Ch          , Ch          , Ch          , Ch          , Ww          , Ww          , Gg          , Ww          , Hh^Fds      , Gs^Fp       , Hh^Fp       , Hh^Fp       , Hh^Fp       
Hh^Fdw      , Hh^Fdf      , Hh^Fmf      , Hh^Fms      , Hh          , Hh          , Hh^Fds      , Hh          , Hh          , Hh^Fdf      , Hh          , Hh^Fds      , Gg          , Gg          , Gg          , Gg          , Gg          , Gg          , Gg          , Gg          , Ww          , Ww          , Ch          , Ch          , Rr          , Rr          , Rr          , Rp^Vhc      , Rp          , Rr          , Rp          , Ch          , Ch          , Ww          , Ww          , Gs^Fp       , Hh^Fdf      , Hh^Fp       , Hh^Fp       , Hh^Fp       
Hh^Fdf      , Hh^Fmf      , Hh^Fms      , Hh          , Ce          , Hh          , Hh          , Hh          , Hh          , Hh          , Hh          , Gg          , Gg          , Chr         , Gg          , Gg          , Gg          , Gg          , Gg          , Gg          , Ww          , Ch          , Rr          , Rr          , Rr          , Rp          , Ch          , Rp          , Ch          , Rp          , Rp          , Rp^Vhc      , Rp          , Ch          , Ww^Bw\      , Gs^Fp       , Rr          , Rr          , Rr          , Rr          
Hh^Fmf      , Hh          , Hh          , Ce          , 3 Ke        , Ce          , Gg          , Re^Vct      , Gg          , Ce          , Gg          , Gg          , Gg          , Gg          , Gg^Vh       , Gg          , Gg          , Gg          , Gg          , Gg          , Ww^Bw/      , Ch          , Rr          , Rp^Vhc      , Rp          , Ch          , Rp^Vhc      , Ch          , Rp^Vhc      , Ch          , Rp          , Rp          , Rp          , Ch          , Ww^Bw\      , Rr          , Rr          , Rr          , Rr          , Rr          
Rp          , Re^Vct      , Gg          , Ce          , Ce          , Ce          , Gg          , Gg          , Rr          , Gg          , Rr          , Gg          , Rp          , Gg          , Rp          , Rp          , Rp          , Rp          , Rp          , Rp          , Ww^Bw/      , Ch          , Rr          , Rr          , Rp          , Ch          , Rp^Vhc      , 2 Kh        , Rp^Vhc      , Ch          , Rp          , Rp^Vhc      , Rp          , Ch          , Ww^Bw\      , Rr          , Rr          , Rr          , Rr          , Rr          
Hh^Fds      , Rp          , Rr          , Gg          , Gg          , Gg          , Re^Vct      , Rr          , Gg          , Rr          , Gg          , Rr          , Rp          , Rp          , Rp          , Rp          , Gg          , Rp          , Gg          , Rp          , Ww          , Ch          , Rr          , Rp^Vhc      , Rp          , Ch          , Ch          , Ch          , Ch          , Ch          , Rp          , Rp          , Rp          , Ch          , Ww          , Rp          , Hh^Fp       , Rr          , Hh^Fp       , Rr          
Hh^Fds      , Hh          , Hh^Fp       , Rr          , Rr          , Rr          , Hh^Fds      , Gg          , Ce          , Gg          , Gg          , Gg          , Rp          , Rp          , Gg          , Gg          , Gg          , Gg          , Hh^Fds      , Gg          , Ww          , Ch          , Ch          , Rp          , Rp          , Rp          , Rp          , Rp          , Rp          , Rp          , Rp          , Rp          , Ch          , Ch          , Ww          , Gg          , Hh^Fp       , Hh^Fp       , Hh^Fms      , Hh^Fp       
Hh^Fdw      , Hh^Fds      , Hh          , Hh^Fdw      , Hh^Fds      , Hh^Fds      , Hh^Fds      , Gg          , Gg          , Gg          , Gg          , Rp          , Gg          , Gg          , Gg          , Gg          , Hh^Fds      , Hh^Fds      , Hh^Fds      , Gg          , Gg         , Ww          , Ww          , Ch          , Ch          , Rp          , Ch          , Rp^Vhc      , Ch          , Rp          , Ch          , Ch          , Ww          , Ww          , Gg          , Gg          , Hh^Fms      , Hh^Fms      , Hh^Fms      , Hh^Fp       
Hh          , Hh^Fp       , Hh^Fp       , Hh^Fds      , Hh^Fds      , Hh^Vhh      , Hh^Fdf      , Gg          , Gg          , Gg          , Gg          , Rp          , Gg          , Gg^Vh       , Gg          , Hh^Fds      , Mm          , Hh^Fds      , Hh^Fds      , Hh^Fds      , Gg          , Gg          , Gg          , Ww          , Ww          , Ch          , Ww^Bw|      , Ch          , Ww^Bw|      , Ch          , Ww          , Ww          , Gg          , Gg          , Gg          , Gg          , Gg          , Hh^Fms      , Hh^Fms      , Hh^Fms      
Rp          , Rp          , Rp          , Hh^Fdw      , Hh          , Hh^Fdf      , Gg          , Gg          , Chr         , Gg          , Gg          , Rp          , Gg          , Gg          , Gg          , Hh^Fds      , Hh^Fds      , Mm          , Hh^Fds      , Gg          , Gg          , Gg          , Gg          , Gg          , Gg         , Ww          , Rr          , Ww^Bw|      , Rr          , Ww          , Gg          , Gg          , Gg          , Gg          , Gg          , Gg          , Gg          , Hh^Fms      , Hh^Fms      , Mm          
Hh^Fdw      , Hh^Fds      , Hh^Fp       , Rp          , Rp          , Rp          , Rp          , Gg          , Gg          , Gg          , Rp          , Rp          , Gg          , Gg          , Gg          , Hh^Fds      , Hh^Fds      , Mm          , Hh^Fds      , Hh^Fds      , Gg          , Gg          , Gg          , Gg          , Gg          , Gg         , Rr          , Rr          , Rr          , Gg          , Gg          , Gg          , Gg          , Gg          , Gg          , Ch          , Hh^Fms      , Hh^Fms      , Hh^Fp       , Mm          
Hh^Fp       , Hh^Fdf      , Mm          , Hh^Fp       , Hh^Fdf      , Hh^Fp       , Gg          , Rp          , Rp          , Gg          , Rp          , Gg          , Gg          , Gg          , Gg          , Hh^Fds      , Hh^Fds      , Mm          , Hh^Fds      , Hh^Fds      , Gg          , Gg          , Gg          , Gg          , Gg          , Gg          , Rr          , Rr          , Rr          , Gg          , Gg          , Gg          , Gg          , Gg          , Gg          , Gg          , Hh^Fms      , Hh^Fms      , Hh^Fp       , Mm          
Hh^Fdf      , Mm          , Mm^Vhh      , Hh          , Hh          , Hh          , Hh^Fmf      , Gg          , Gg          , Rp          , Rp          , Gg          , Gg          , Gg          , Hh^Fds      , Hh^Fds      , Hh^Fds      , Hh^Fds      , Hh^Fds      , Gg          , Gg          , Gg          , Gg          , Gg          , Gg^Vh       , Gg          , Rr          , Rr          , Rr          , Gg          , Gg          , Gg^Vh       , Gg          , Gg          , Gg          , Hh^Fms      , Ww          , Hh^Fms      , Hh^Fp       , Mm          
Hh^Fp       , Mm          , Mm          , Mm          , Hh          , Hh          , Hh^Fmf      , Gg          , Gg          , Gg          , Gg          , Rp          , Rp          , Gg          , Gg          , Gg          , Gg          , Hh^Fds      , Gg          , Gg          , Gg          , Gg          , Gg          , Gg          , Gg          , Gg          , Rr          , Rr          , Rr          , Gg          , Gg          , Gg          , Gg          , Gg          , Gg          , Gg          , Ww          , Hh^Fms      , Hh^Fp       , Mm          
Mm          , Mm          , Hh^Fp       , Mm          , Hh^Fmf      , Hh          , Gg          , Ww          , Ww          , Ch          , Ch          , Gg          , Gg          , Rp          , Rp          , Gg          , Gg          , Gg          , Gg          , Gg          , Rp          , Gg          , Gg          , Gg          , Gg          , Gg          , Rr          , Rr          , Rr          , Gg          , Gg          , Gg          , Gg          , Gg          , Gg          , Gg          , Hh^Fms      , Hh^Fms      , Hh^Fp       , Mm          
Hh          , Hh^Fp       , Hh^Fp       , Hh^Fp       , Hh^Fds      , Hh          , Gg          , Gg          , Gg          , Gg          , Gg          , Gg          , Gg          , Gg          , Gg          , Rp          , Rp          , Gg          , Rp          , Rp          , Gg          , Rp          , Rp          , Gg          , Gg          , Gg          , Rr          , Rr          , Rr          , Rr          , Rr          , Gg          , Gg          , Ch          , Gg          , Hh^Fms      , Hh^Fms      , Hh^Fms      , Mm          , Mm          
Rp          , Hh^Fds      , Rp          , Hh^Fds      , Rp          , Rp          , Rp          , Gg          , Rp          , Rp          , Rp          , Rp          , Rp          , Gg          , Rp          , Rp          , Gg          , Rp          , Gg          , Gg          , Gg          , Gg          , Gg          , Rp          , Rp          , Gg          , Rr          , Rr          , Rp          , Rr          , Rr          , Rr          , Rr          , Gg          , Gg          , Hh^Fms      , Hh^Fms      , Hh^Fms      , Hh^Fp       , Mm          
Hh^Fds      , Rp          , Hh^Fds      , Rp          , Hh^Fds      , Hh^Fds      , Hh^Fds      , Rp          , Hh^Fds      , Hh^Fp       , Hh          , Hh^Fp       , Hh^Fp       , Rp          , Gg          , Gg          , Rp          , Rp          , Gg          , Gg          , Ww          , Gg          , Ww          , Gg          , Gg          , Rp          , Rp          , Rp          , Gg          , Gg          , Gg          , Rr          , Rr          , Rr          , Rr          , Hh^Fp       , Hh^Fp       , Hh^Fp       , Hh^Fp       , Hh^Fp       
Mm          , Hh^Fds      , Hh^Fdf      , Hh          , Hh^Fp       , Hh^Vhh      , Hh^Fp       , Hh          , Ce          , Hh          , Mm          , Hh^Fp       , Hh          , Hh^Fdf      , Gg          , Gg          , Rp          , Gg          , Gg          , Gg          , Ww          , Ww          , Ww          , Gg          , Gg          , Gg          , Gg          , Gg          , Gg          , Gg          , Gg          , Gg          , Gg          , Rr          , Rr          , Rr          , Rr          , Hh^Fp       , Rr          , Rr          
Mm          , Hh          , Hh^Fdf      , Hh^Fp       , Mm          , Hh^Fp       , Hh^Fp       , Ce          , 4 Ke        , Ce          , Mm          , Mm          , Mm          , Hh^Fp       , Hh^Fdf      , Rp          , Gg          , Gg          , Gg^Vh       , Gg          , Ww          , Ww          , Gg          , Gg          , Gg          , Gg          , Gg          , Gg          , Gg^Vh       , Gg          , Gg          , Gg          , Gg          , Gg          , Gg          , Rp          , Rp          , Rr          , Hh^Fp       , Hh^Fp       
Mm          , Mm          , Mm          , Mm          , Mm          , Hh^Fdf      , Mm          , Ce          , Ce          , Ce          , Mm          , Mm^Vhh      , Mm          , Hh^Fp       , Hh^Fp       , Rp          , Gg          , Gg          , Gg          , Gg          , Gg          , Gg          , Gs^Fp       , Hh^Fds      , Hh^Fds      , Gg          , Gg          , Gg          , Gg          , Gg          , Ce          , Gg          , Gg          , Gg          , Gg          , Gg          , Rr          , Hh^Fp       , Hh^Fds      , Hh^Fds      
Mm          , Mm          , Mm          , Hh^Fdf      , Mm          , Mm          , Hh^Fdw      , Hh^Fdw      , Hh^Fp       , Mm          , Mm          , Mm          , Hh^Fdf      , Hh^Fds      , Hh^Fdf      , Rp          , Gg          , Gg          , Gg          , Gg          , Gg          , Gg          , Hh^Fds      , Gs^Fds      , Hh^Fds      , Gs^Fp       , Gg          , Gg          , Gg          , Ce          , 1 Ke        , Ce          , Gg          , Gg          , Gg          , Gg          , Rr          , Hh^Fds      , Hh^Fds      , Hh^Fds      
Mm          , Mm          , Hh^Fds      , Hh          , Hh          , Hh^Fp       , Hh^Fp       , Hh^Fdf      , Hh^Fdf      , Hh          , Mm          , Mm          , Hh^Fdf      , Hh^Fdw      , Rp          , Rp          , Gg          , Gg          , Gg          , Gg          , Hh^Fds      , Gs^Fp       , Hh^Fds      , Hh^Fp       , Hh^Fds      , Gs^Fp       , Hh^Fds      , Gg          , Gg          , Ce          , Ce          , Ce          , Gg          , Gg^Vh       , Gg          , Gg          , Rr          , Hh^Fds      , Hh^Fds      , Hh^Fds      
Mm          , Mm          , Hh^Fds      , Hh^Fdf      , Hh          , Hh^Fds      , Hh^Fdw      , Hh^Fds      , Hh^Fdw      , Hh^Fp       , Hh^Fp       , Hh^Fdw      , Hh^Fdw      , Hh^Fds      , Hh^Fdw      , Rp          , Gg          , Gg          , Gg          , Hh^Fds      , Gs^Fp       , Hh^Fds      , Hh^Fds      , Hh^Fds      , Hh^Fds      , Gs^Fp       , Gs^Fp       , Gg          , Gg          , Gg          , Gg          , Gg          , Gg          , Gg          , Gg          , Gg          , Rr          , Hh^Fds      , Hh^Fds      , Hh^Fds      
