border_size=1
usage=map

Gs^Fp       , Gg          , Hh^Fp       , Gg          , Hh^Fp       , Hh^Fp       , Hh^Fp       , Hh^Fp       , Mm          , Mm          , Mm          , Mm^Xm       , Mm          , Ww          , Mm^Xm       , Mm^Xm       , Mm          , Mm          , Mm          , Mm          , Mm          , Mm          , Mm^Xm       , Mm          , Mm^Xm       , Mm          , Mm          
Gs^Fp       , Gs^Fp       , Gs^Fp       , Hh^Fp       , Hh^Fp       , Hh          , Mm          , Mm          , Ce          , Ce          , Ce          , Mm          , Mm          , Ww          , Ww          , Mm          , Mm          , Mm          , Mm^Vhh      , Mm          , Mm          , Mm          , Mm          , Mm          , Mm          , Mm          , Mm^Xm       
Gs^Fp       , Gg^Ve       , Gs^Fp       , Hh^Fp       , Hh          , Hh          , Mm          , Mm          , Ce          , 3 Ke        , Ce          , Mm          , Mm          , Mm          , Ww          , Mm          , Mm          , Mm          , Mm          , Mm          , Mm          , Mm          , Mm          , Mm          , Mm          , Mm          , Mm          
Gs^Fp       , Gs^Fp       , Gs^Fp       , Hh          , Hh^Fp       , Mm^Vc       , Mm          , Mm          , Mm          , Ce          , Mm          , Mm          , Ww          , Ww          , Mm          , Ww          , Ww          , Mm          , Mm          , Mm          , Mm^Vhh      , Mm          , Mm          , Mm^Vc       , Mm          , Mm          , Mm^Xm       
Gs^Fp       , Gs^Fp       , Hh^Fp       , Hh^Fp       , Ww          , Mm          , Ww          , Mm          , Ww          , Mm          , Ww          , Ww          , Mm          , Mm          , Mm          , Mm          , Mm          , Ww          , Ww          , Mm          , Mm          , Mm          , Mm          , Mm          , Mm          , Mm          , Mm          
Gs^Fp       , Gs^Fp       , Ww          , Ww          , Hh^Fp       , Ww          , Mm          , Ww          , Mm          , Ww          , Mm          , Mm          , Mm          , Mm          , Mm^Vhh      , Mm          , Mm          , Mm          , Mm          , Ww          , Ww          , Mm          , Mm          , Mm          , Mm          , Mm          , Mm^Xm       
Ww          , Ww          , Ww          , Hh^Fp       , Hh^Fp       , Mm          , Mm          , Mm          , Mm          , Mm          , Mm          , Mm          , Mm          , Mm          , Mm          , Mm          , Mm          , Mm          , Mm          , Mm          , Mm          , Ww          , Ww          , Mm          , Mm          , Mm          , Ww          
Ww          , Ww          , Hh^Fp       , Hh^Fp       , Hh^Fp       , Mm          , Mm          , Mm^Vc       , Mm          , Mm          , Mm          , Mm          , Mm          , Mm          , Mm          , Mm          , Mm          , Mm          , Cud         , Mm          , Cud         , Mm          , Mm          , Ww          , Ww          , Ww          , Mm          
Hh^Fp       , Hh^Fp       , Hh^Fp       , Hh^Fp       , Hh          , Mm          , Mm          , Mm          , Mm          , Mm          , Mm          , Mm^Vc       , Mm          , Mm          , Mm          , Mm          , Mm          , Cud         , Cud         , Cud         , Cud         , Cud         , Mm          , Mm          , Mm          , Mm^Xm       , Mm          
Gs^Fp       , Gs^Fp       , Gs^Fp       , Hh^Fp       , Hh^Fdf      , Hh          , Hh^Fdf      , Hh^Fdf      , Mm          , Mm          , Mm          , Mm          , Mm          , Mm          , Mm          , Mm          , Mm          , Cud         , Cud         , 2 Kud       , Cud         , Cud         , Mm          , Mm          , Mm          , Mm^Xm       , Mm          
Gs^Fp       , Gs^Fp       , Hh^Fp       , Gs^Fp       , Hh^Fp       , Hh^Fdf      , Hh^Fp       , Hh          , Hh^Fdf      , Mm          , Mm          , Mm          , Mm          , Mm          , Mm^Vhh      , Mm          , Mm          , Cud         , Mm          , Cud         , Mm          , Cud         , Mm          , Mm          , Mm          , Mm^Xm       , Mm^Xm       
Gs^Fp       , Gs^Fp       , Gg^Vl       , Gs^Fp       , Gs^Fp       , Hh^Fdf      , Hh^Fdf      , Hh^Fdf      , Hh          , Hh          , Hh^Fdf      , Mm          , Mm          , Mm          , Mm          , Mm          , Mm          , Mm          , Mm          , Mm          , Mm          , Mm          , Mm          , Mm          , Mm          , Mm          , Mm          
Gs^Fp       , Gs^Fp       , Gs^Fp       , Gs^Fp       , Gs^Fp       , Hh^Fp       , Gs^Fp       , Hh^Fdf      , Hh          , Hh^Fdf      , Hh^Fp       , Hh^Fp       , Hh^Fp       , Mm          , Mm          , Mm          , Hh^Fdf      , Mm          , Mm          , Mm          , Mm          , Mm          , Mm          , Mm^Vc       , Mm          , Mm          , Mm          
Re          , Gs^Fp       , Gg          , Gs^Fp       , Gs^Fp       , Gs^Fp       , Hh^Fp       , Hh^Fp       , Hh          , Hh^Fdf      , Hh          , Hh^Fdf      , Hh^Fdf      , Hh          , Hh^Fdf      , Hh^Fdf      , Hh^Fp       , Hh          , Hh          , Hh          , Hh^Fdf      , Mm          , Mm          , Mm          , Hh          , Hh^Fdf      , Hh^Fdf      
Gg          , Re^Vct      , Re          , Gs^Fp       , Gs^Fp       , Gs^Fp       , Hh^Fp       , Hh          , Hh^Fp       , Hh^Fp       , Hh^Fp       , Hh^Vhh      , Hh^Fdf      , Hh^Fdf      , Hh^Fp       , Hh^Fdf      , Hh^Fdf      , Hh^Fdf      , Hh^Fp       , Hh          , Hh^Fdf      , Hh^Fp       , Hh^Fdf      , Hh^Fdf      , Hh^Fdf      , Hh^Fp       , Hh          
Gg          , Gg          , Ce          , Re          , Re          , Gg          , Gg          , Hh          , Re          , Hh          , Re          , Hh^Fp       , Hh^Fp       , Hh^Fp       , Gg          , Hh^Fdf      , Re          , Hh^Fdf      , Hh^Fp       , Hh^Vhh      , Gg          , Hh          , Gg          , Hh          , Hh^Fdf      , Hh^Vhh      , Hh^Fdf      
Gg          , Ce          , 4 Ke        , Ce          , Gg          , Re          , Re          , Re          , Gs^Fp       , Re          , Gg          , Re          , Re          , Re          , Re          , Re          , Gg          , Re          , Re          , Re          , Re          , Re          , Re          , Re          , Re          , Gg          , Re          
Gg          , Ce          , Ce          , Ce          , Gg          , Gg          , Re          , Gg          , Gs^Fp       , Gs^Fp       , Hh^Fds      , Gg          , Hh          , Gg          , Hh^Fdf      , Gg          , Hh^Fp       , Gg          , Hh^Fdf      , Gg          , Gg          , Gg          , Hh^Fp       , Gg          , Hh^Fp       , Re          , Gg          
Gg          , Gg          , Gg          , Gg          , Re          , Re^Vct      , Gg          , Gg          , Gs^Fp       , Gs^Fp       , Gs^Fp       , Hh^Fds      , Hh^Fds      , Hh^Fdf      , Mm          , Hh          , Hh^Fds      , Hh^Fdf      , Hh          , Hh          , Hh          , Hh^Fdf      , Hh          , Hh^Fp       , Ce          , Hh^Fp       , Hh          
Gg          , Gg          , Re          , Re          , Gg          , Gg          , Gs^Fp       , Gs^Fp       , Gs^Fp       , Gs^Fp       , Gs^Fp       , Gs^Fp       , Gs^Fp       , Hh^Fds      , Mm          , Mm          , Mm          , Hh^Fp       , Mm          , Mm          , Hh          , Hh^Fp       , Hh^Fp       , Ce          , 1 Ke        , Ce          , Hh^Fp       
Re          , Re          , Gs^Fp       , Gs^Fp       , Gs^Fp       , Gs^Fp       , Gs^Fp       , Gg^Vl       , Gs^Fp       , Gs^Fp       , Gs^Fp       , Gs^Fp       , Hh^Fds      , Hh^Fdf      , Hh^Fp       , Mm          , Hh^Fp       , Hh^Fdf      , Hh^Fp       , Mm          , Hh          , Hh^Fdf      , Hh          , Ce          , Ce          , Ce          , Gs^Fp       
Gs^Fp       , Gg          , Gs^Fp       , Gs^Fp       , Gs^Fp       , Gs^Fp       , Gs^Fp       , Gs^Fp       , Gs^Fp       , Gs^Fp       , Gs^Fp       , Gs^Fp       , Hh^Fp       , Gs^Fp       , Gs^Fp       , Hh^Fdf      , Gs^Fp       , Hh^Fdf      , Gs^Fp       , Hh^Fdf      , Hh          , Hh^Vhh      , Gs^Fp       , Gs^Fp       , Gs^Fp       , Hh^Fp       , Gs^Fp       
Gs^Fp       , Gs^Fp       , Gs^Fp       , Gs^Fp       , Gs^Fp       , Gs^Fp       , Gs^Fp       , Gs^Fp       , Gs^Fp       , Gs^Fp       , Gs^Fp       , Gs^Fp       , Gs^Fp       , Hh^Fp       , Gs^Fp       , Gs^Fp       , Gs^Fp       , Gs^Fp       , Gs^Fp       , Hh^Fp       , Gs^Fp       , Gs^Fp       , Gs^Fp       , Hh^Fp       , Gs^Fp       , Gs^Fp       , Gs^Fp       
Gs^Fp       , Gs^Fp       , Ce          , Ce          , Ce          , Gs^Fp       , Gs^Fp       , Gs^Fp       , Gs^Fp       , Gs^Fp       , Gs^Fp       , Gs^Fp       , Gs^Fp       , Gg^Ve       , Gs^Fp       , Gs^Fp       , Gs^Fp       , Gs^Fp       , Gs^Fp       , Gs^Fp       , Gs^Fp       , Gs^Fp       , Gs^Fp       , Gs^Fp       , Gg^Ve       , Gs^Fp       , Gs^Fp       
Gs^Fp       , Gs^Fp       , Ce          , 5 Ke        , Ce          , Gs^Fp       , Gs^Fp       , Gs^Fp       , Gg^Vl       , Gs^Fp       , Gs^Fp       , Gs^Fp       , Gs^Fp       , Gs^Fp       , Gs^Fp       , Gs^Fp       , Gs^Fp       , Gs^Fp       , Gs^Fp       , Gs^Fp       , Gg^Vl       , Gs^Fp       , Gs^Fp       , Gs^Fp       , Gs^Fp       , Gs^Fp       , Gs^Fp       
Gs^Fp       , Gs^Fp       , Gs^Fp       , Ce          , Gs^Fp       , Gs^Fp       , Gs^Fp       , Gs^Fp       , Gs^Fp       , Gs^Fp       , Gs^Fp       , Gs^Fp       , Gs^Fp       , Gs^Fp       , Gs^Fp       , Gs^Fp       , Gs^Fp       , Gs^Fp       , Gs^Fp       , Gs^Fp       , Gs^Fp       , Gs^Fp       , Gs^Fp       , Gs^Fp       , Gs^Fp       , Gs^Fp       , Gs^Fp       
Gs^Fp       , Gs^Fp       , Gs^Fp       , Gs^Fp       , Gs^Fp       , Gs^Fp       , Gs^Fp       , Gs^Fp       , Gs^Fp       , Gs^Fp       , Gs^Fp       , Gs^Fp       , Gs^Fp       , Gs^Fp       , Gs^Fp       , Gs^Fp       , Gs^Fp       , Gs^Fp       , Gs^Fp       , Gs^Fp       , Gs^Fp       , Gs^Fp       , Gs^Fp       , Gs^Fp       , Gs^Fp       , Gs^Fp       , Gg          
