border_size=1
usage=map

Rr          , Xos         , Ur          , Ur          , Ur          , Ur          , Ur          , Ur          , Ur          , Ur          , Ur          , Ur          , Ur          , Ur          , Ur          , Ur          , Ur          , Ur          , Uu          , Xos         , Xos         
Ur          , Rr          , Rr          , Uu^Vud      , Ur          , Ur          , Ur          , Uu^Vud      , Ur          , Ur          , Ur          , Ur          , Uu^Vud      , Ur          , Ur          , Ur          , Ur          , Ur          , Ur          , Xos         , Rr          
Ur          , Uh          , Uh          , Rr          , Rr          , Ur          , Cud         , Ur          , Ur          , Ur          , Cud         , Ur          , Ur          , Ur          , Cud         , Ur          , Ur          , Ur          , Ur          , Rr          , Uh          
Xos         , Uh          , Ur          , Ur          , Uu^Vud      , Rr          , Ur          , Ur          , Uu^Vud      , Ur          , Ur          , Ur          , Ur          , Ur          , Ur          , Ur          , Ur          , Ur          , Rr          , Rr          , Uh          
Xos         , Xos         , Ur          , Ur          , Ur          , Rr          , Rr          , Ur          , Ur          , Ur          , Ur          , Ur          , Uu^Vud      , Ur          , Ur          , Ur          , Ur          , Uu^Vud      , Rr          , Uh          , Uh          
Xos         , Xos         , Ur          , Ur          , Ur          , Ur          , Rr          , Rr          , Rr          , Rr          , Rr          , Rr          , Rr          , Rr          , Rr          , Rr          , Rr          , Rr          , Ur          , Ur          , Xos         
Xos         , Xos         , Ur          , Ur          , Rr          , Rr          , Cud         , Cud         , Cud         , Cud         , Cud         , Cud         , Cud         , Cud         , Cud         , Rr          , Rr          , Ur          , Ur          , Xos         , Xos         
Xos         , Xos         , Uu^Vud      , Ur          , Rr          , Cud         , Cud         , Cud         , Cud         , Cud         , Cud         , Cud         , Cud         , Cud         , Cud         , Cud         , Rr          , Ur          , Uu^Vud      , Xos         , Xos         
Xos         , Xos         , Ur          , Ur          , Rr          , Cud         , Cud         , Cud         , Cud         , Cud         , Cud         , Cud         , Cud         , Cud         , Cud         , Cud         , Rr          , Ur          , Ur          , Xos         , Xos         
Xos         , Xos         , Ur          , Ur          , Rr          , Cud         , Cud         , Cud         , 2 Kud       , Cud         , Cud         , Cud         , 1 Kud       , Cud         , Cud         , Cud         , Rr          , Ur          , Ur          , Xos         , Xos         
Xos         , Xos         , Uu^Vud      , Ur          , Rr          , Cud         , Cud         , Cud         , Cud         , Cud         , Cud         , Cud         , Cud         , Cud         , Cud         , Cud         , Rr          , Ur          , Uu^Vud      , Xos         , Xos         
Xos         , Xos         , Ur          , Ur          , Rr          , Cud         , Cud         , Cud         , Cud         , Cud         , Cud         , Cud         , Cud         , Cud         , Cud         , Cud         , Rr          , Ur          , Ur          , Xos         , Xos         
Xos         , Xos         , Ur          , Ur          , Rr          , Cud         , Cud         , Cud         , Cud         , Cud         , Cud         , Cud         , Cud         , Cud         , Cud         , Cud         , Rr          , Ur          , Ur          , Xos         , Xos         
Xos         , Xos         , Ur          , Ur          , Rr          , Rr          , Rr          , Cud         , Rr          , Cud         , Rr          , Cud         , Rr          , Cud         , Rr          , Rr          , Rr          , Ur          , Ur          , Xos         , Xos         
Xos         , Xos         , Ur          , Rr          , Rr          , Rr          , Ur          , Rr          , Ur          , Rr          , Ur          , Rr          , Uu^Vud      , Rr          , Ur          , Rr          , Rr          , Ur          , Ur          , Xos         , Xos         
Xos         , Xos         , Ur          , Uu^Vud      , Rr          , Ur          , Ur          , Uu^Vud      , Ur          , Ur          , Ur          , Ur          , Ur          , Ur          , Ur          , Ur          , Ur          , Rr          , Rr          , Xos         , Xos         
Xos         , Xos         , Ur          , Rr          , Ur          , Ur          , Cud         , Ur          , Ur          , Ur          , Cud         , Ur          , Ur          , Ur          , Cud         , Ur          , Ur          , Ur          , Ur          , Rr          , Uh          
Xos         , Xos         , Rr          , Rr          , Ur          , Ur          , Xos         , Xos         , Ur          , Xos         , Xos         , Ur          , Ur          , Ur          , Ur          , Ur          , Ur          , Ur          , Ur          , Rr          , Ur          
Rr          , Rr          , Ur          , Uu^Vud      , Ur          , Ur          , Xos         , Ur          , Ur          , Ur          , Ur          , Xos         , Ur          , Ur          , Ur          , Ur          , Ur          , Uu^Vud      , Ur          , Rr          , Rr          
Ur          , Ur          , Uh          , Ur          , Ur          , Ur          , Xos         , Ur          , Ur          , Ur          , Ur          , Xos         , Uu^Vud      , Ur          , Ur          , Ur          , Ur          , Ur          , Ur          , Ur          , Uh          
Uu          , Uh          , Ur          , Ur          , Ur          , Ur          , Ur          , Xos         , Xos         , Ur          , Xos         , Xos         , Ur          , Ur          , Ur          , Ur          , Ur          , Ur          , Ur          , Uh          , Uu          
