border_size=1
usage=map

Mm          , Mm          , Mm          , Mm          , Mm          , Mm          , Mm          , Mm          , Mm          , Mm          , Hh          , Mm          , Mm          , Mm          , Mm          , Mm          , Hh          , Mm          , Ww          , Hh          , Hh          , Mm          , Mm          , Mm          , Mm          , Mm          , Hh          , Mm          , Mm          , Mm          , Mm          , Mm          
Mm          , Mm          , Mm          , Mm^Vhh      , Mm          , Mm          , Mm          , Mm          , Mm          , Mm          , Hh          , Mm          , Mm          , Mm          , Mm          , Mm          , Hh^Fp       , Mm          , Ww          , Hh          , Hh          , Mm          , Mm          , Mm          , Mm          , Mm          , Hh^Fp       , Mm          , Mm          , Mm          , Mm          , Mm          
Mm          , Mm          , Hh^Fp       , Mm          , Mm          , Mm          , Mm          , Mm          , Mm          , Mm          , Mm          , Mm          , Mm          , Mm          , Mm          , Mm          , Hh^Fp       , Ww          , Ww          , Hh^Fp       , Hh^Fp       , Mm          , Hh          , Hh^Vhh      , Gs^Fp       , Mm          , Hh          , Hh          , Mm          , Mm          , Mm          , Mm          
Gs^Fp       , Gs^Fp       , Gs^Fp       , Hh^Fp       , Hh          , Mm          , Hh^Fp       , Mm          , Hh^Fp       , Mm          , Mm^Vhh      , Mm          , Mm          , Mm          , Mm          , Mm^Vhh      , Mm          , Hh          , Hh^Fp       , Ww          , Gs^Fp       , Hh^Fp       , Gs^Fp       , Gs^Fp       , Re          , Gs^Fp       , Re          , Hh          , Hh^Fp       , Hh          , Mm          , Mm          
Gs^Fp       , Ce          , Ce          , Ce          , Ce          , Hh^Fp       , Re          , Hh^Fp       , Gs^Fp       , Hh^Fp       , Hh^Fp       , Hh^Fp       , Hh^Fp       , Mm          , Mm          , Mm          , Hh          , Hh^Fp       , Hh          , Gg^Vh       , Re          , Re          , Gs^Fp       , Re          , Hh^Fp       , Gs^Fp       , Hh^Fp       , Re          , Gs^Fp       , Hh          , Hh^Fp       , Hh          
Gs^Fp       , Ce          , Ce          , 1 Ke        , Ce          , Re          , Hh^Fp       , Re          , Hh^Fp       , Re          , Re          , Hh^Fp       , Gs^Fp       , Hh^Fp       , Hh^Fp       , Hh^Fp       , Gs^Fp       , Gs^Fp       , Gs^Fp       , Re          , Hh          , Hh          , Mm          , Mm          , Hh          , Hh          , Khr         , Hh          , Gs^Fp       , Re          , Gs^Fp       , Re          
Gs^Fp       , Ce          , Hh^Fp       , Ce          , Hh^Fp       , Hh          , Mm          , Hh          , Gg^Ve       , Hh^Fp       , Gs^Fp       , Re          , Gs^Fp       , Re          , Re          , Hh^Fp       , Re          , Re          , Hh          , Hh          , Mm          , Mm          , Mm          , Mm          , Mm          , Hh          , Hh          , Hh^Fp       , Hh          , Re          , Hh^Fp       , Gs^Fp       
Mm          , Mm          , Mm          , Mm          , Mm          , Mm          , Mm          , Mm          , Hh^Fp       , Gs^Fp       , Hh          , Hh          , Mm          , Hh^Fp       , Hh          , Re          , Hh^Fp       , Hh^Fp       , Hh^Vhh      , Mm          , Mm          , Mm          , Mm          , Mm          , Mm          , Mm          , Mm          , Hh          , Hh^Fp       , Re          , Gg^Ve       , Gg          
Mm          , Mm          , Mm^Vhh      , Mm          , Hh          , Mm          , Mm          , Mm          , Mm          , Hh          , Mm          , Mm          , Mm          , Mm          , Mm          , Gs^Fp       , Hh          , Hh          , Mm          , Mm          , Mm          , Hh          , Mm          , Mm          , Mm          , Mm          , Mm          , Mm          , Mm          , Gs^Fp       , Hh          , Hh          
Hh          , Hh          , Hh          , Hh          , Hh          , Hh          , Mm^Vhh      , Mm          , Mm          , Mm          , Hh          , Hh^Fp       , Ww          , Hh^Fp       , Ww          , Gg^Vh       , Hh^Fp       , Hh^Fp       , Hh          , Mm          , Hh          , Mm          , Hh          , Mm          , Mm          , Mm          , Hh          , Mm          , Mm          , Re          , Hh          , Hh          
Ss          , Ss          , Ss          , Ss          , Hh          , Mm          , Hh          , Mm          , Hh          , Mm          , Hh^Fp       , Hh^Fp       , Wo          , Ww          , Ww          , Wwf         , Wwf         , Hh          , Ww          , Hh^Fp       , Ww          , Hh          , Ww          , Hh          , Ww          , Hh          , Ww          , Hh          , Hh          , Re          , Mm          , Mm          
Ww          , Ww          , Ww          , Ww          , Ww          , Hh^Fp       , Ww          , Hh          , Ss          , Hh          , Ww          , Ww          , Wo          , Wo          , Wo          , Ww          , Wwf         , Ww          , Wo          , Ww          , Wo          , Ww          , Wo          , Ww          , Wo          , Ww          , Ww          , Ww          , Gg^Ve       , Gs^Fp       , Mm          , Mm          
Wo          , Wo          , Wo          , Wo          , Wo          , Ww          , Wo          , Ww          , Ww          , Ww          , Ww          , Ww          , Wo          , Wo          , Wo          , Ww          , Wwf         , Ww          , Wo          , Wo          , Wo          , Wo          , Ww          , Wo          , Ww          , Wo          , Ww          , Hh          , Hh          , Re          , Mm          , Mm          
Wo          , Wo          , Wo          , Wo          , Wo          , Wo          , Wo          , Wo          , Wo          , Wo          , Wo          , Wo          , Wo          , Wo          , Ww          , Ww          , Wwf         , Ww          , Ww          , Ww          , Ww          , Ww          , Hh          , Ww          , Hh          , Ww          , Ww          , Mm          , Hh^Fp       , Re          , Hh^Fp       , Hh          
Wo          , Wo          , Wo          , Wo          , Wo          , Wo          , Wo          , Wo          , Wo          , Wo          , Wo          , Wo          , Ww          , Ww          , Ww          , Ww          , Wwf         , Wwf         , Hh^Fp       , Hh^Fp       , Hh          , Hh^Fp       , Mm          , Mm          , Hh          , Gg^Ve       , Re          , Ww          , Ww          , Ww^Bw|      , Ww          , Ww          
Ww          , Ww          , Ww          , Wo          , Ww          , Wo          , Ww          , Wo          , Wo          , Wo          , Wo          , Wo          , Ww          , Hh^Fp       , Hh          , Hh^Fp       , Mm          , Hh          , Hh          , Hh          , Mm          , Mm          , Hh          , Hh          , Re          , Re          , Mm          , Re          , Re          , Re          , Mm          , Mm          
Ww          , Ww          , Ss          , Ww          , Ss          , Ww          , Gg^Vh       , Ww          , Ww          , Ww          , Ww          , Ww          , Hh          , Hh          , Mm          , Mm          , Mm          , Mm          , Gg          , Mm          , Mm          , Mm          , Hh          , Mm          , Gs^Fp       , Hh^Fp       , Hh          , Mm          , Mm          , Gg^Ve       , Mm          , Mm          
Hh          , Hh          , Hh          , Ss          , Hh          , Hh          , Mm          , Hh          , Hh          , Ss          , Hh          , Ss          , Hh          , Hh          , Mm          , Mm          , Hh          , Gg^Ve       , Gg          , Hh          , Hh          , Hh          , Hh          , Hh          , Re          , Hh^Fp       , Mm          , Mm          , Mm          , Mm          , Mm          , Mm          
Mm          , Mm          , Mm          , Hh^Fp       , Mm          , Mm          , Mm          , Hh^Fp       , Mm          , Hh          , Mm          , Hh          , Mm          , Mm          , Hh          , Mm          , Hh          , Hh          , Hh          , Hh          , Gs^Fp       , Gs^Fp       , Gs^Fp       , Gg          , Gs^Fp       , Gs^Fp       , Hh          , Mm          , Mm          , Mm          , Mm          , Mm          
Mm          , Mm          , Mm          , Mm          , Mm          , Mm          , Mm          , Mm          , Mm          , Mm          , Mm          , Mm          , Mm          , Mm          , Hh          , Hh          , Gs^Fp       , Gs^Fp       , Gs^Fp       , Hh          , Gs^Fp       , Re          , Re          , Re          , Hh^Fp       , Hh^Fp       , Hh^Fp       , Mm          , Mm          , Mm          , Mm          , Mm          
Mm          , Mm          , Mm          , Mm          , Gg^Ve       , Mm          , Hh          , Mm          , Hh          , Mm          , Hh          , Gg^Ve       , Hh          , Hh          , Hh^Fp       , Gs^Fp       , Re          , Re          , Re          , Gs^Fp       , Hh          , Hh          , Mm          , Gg^Ve       , Hh^Fp       , Hh          , Mm          , Mm          , Mm          , Mm          , Mm          , Mm          
Mm          , Mm          , Hh          , Hh          , Hh^Fp       , Hh          , Hh^Fp       , Hh          , Hh^Fp       , Hh          , Hh^Fp       , Gg          , Gg          , Hh^Fp       , Re          , Gs^Fp       , Mm          , Hh          , Gg^Ve       , Mm          , Mm          , Mm          , Mm          , Hh^Fp       , Hh          , Hh          , Mm          , Mm          , Mm          , Mm          , Mm          , Mm          
Hh          , Hh          , Hh^Fp       , Gs^Fp       , Hh^Fp       , Hh^Fp       , Chr         , Hh          , Hh^Fp       , Hh          , Hh^Fp       , Hh^Fp       , Gg          , Gs^Fp       , Hh          , Mm          , Mm          , Mm          , Mm          , Mm          , Mm          , Mm          , Mm          , Mm          , Mm          , Mm          , Mm          , Khr         , Mm          , Mm          , Mm          , Mm          
Hh^Fp       , Hh^Fp       , Re          , Gs^Fp       , Re          , Re          , Re          , Re          , Re          , Hh^Fp       , Re          , Gs^Fp       , Re          , Re          , Mm          , Mm          , Mm          , Mm          , Mm          , Mm          , Mm          , Mm          , Mm          , Mm          , Mm          , Mm          , Mm          , Mm          , Mm          , Mm          , Mm          , Mm          
Gg          , Gs^Fp       , Re          , Gs^Fp       , Gs^Fp       , Gg          , Hh          , Chr         , Hh          , Re          , Hh          , Hh          , Hh          , Mm          , Mm          , Mm          , Mm          , Mm          , Mm          , Mm          , Hh          , Mm          , Mm          , Mm          , Mm          , Mm          , Mm          , Mm          , Mm          , Mm          , Mm          , Mm          
Re          , Gs^Fp       , Gs^Fp       , Gs^Fp       , Hh          , Hh          , Mm          , Hh          , Mm          , Gg^Ve       , Mm          , Mm          , Mm          , Mm          , Mm          , Mm          , Mm          , Mm          , Mm          , Mm          , Hh          , Hh          , Mm          , Mm          , Mm          , Mm          , Mm          , Mm          , Mm          , Mm          , Mm          , Mm          
Gs^Fp       , Re          , Gs^Fp       , Hh          , Mm          , Mm          , Mm          , Mm          , Mm          , Mm          , Mm          , Mm          , Mm          , Mm          , Mm          , Gg^Ve       , Mm          , Mm          , Mm          , Mm          , Mm          , Mm          , Mm          , Mm          , Mm          , Mm          , Mm          , Mm          , Mm          , Mm          , Mm          , Mm          
Gs^Fp       , Re          , Gs^Fp       , Hh          , Mm          , Mm          , Hh^Fp       , Mm          , Mm          , Mm          , Mm          , Mm          , Mm          , Mm          , Mm          , Mm          , Mm          , Mm          , Mm          , Mm          , Mm          , Mm          , Mm          , Mm          , Mm          , Mm          , Mm          , Mm          , Hh^Fp       , Hh^Fp       , Hh^Fp       , Mm          
Gg          , Gs^Fp       , Gs^Fp       , Hh          , Hh^Fp       , Hh^Fp       , Gg^Ve       , Hh^Fp       , Hh          , Hh          , Hh          , Mm          , Hh^Fp       , Mm          , Mm          , Mm          , Hh^Fp       , Mm          , Mm          , Mm          , Mm          , Mm          , Mm          , Mm          , Hh          , Mm          , Hh^Fp       , Mm          , Hh^Fp       , Gg^Ve       , Gs^Fp       , Hh^Fp       
Gg          , Gs^Fp       , Re          , Gs^Fp       , Gg          , Hh          , Hh^Fp       , Hh^Fp       , Gs^Fp       , Hh^Fp       , Hh^Fp       , Hh          , Hh^Fp       , Hh          , Mm          , Hh^Fp       , Gg^Ve       , Hh          , Hh          , Mm          , Mm          , Mm          , Hh^Fp       , Mm          , Hh          , Hh^Fp       , Gs^Fp       , Hh^Fp       , Hh^Fp       , Gs^Fp       , Gs^Fp       , Gs^Fp       
Gg          , Gg^Ve       , Hh^Fp       , Gs^Fp       , Re          , Gs^Fp       , Gs^Fp       , Gs^Fp       , Gs^Fp       , Gs^Fp       , Gs^Fp       , Hh^Fp       , Gs^Fp       , Hh^Fp       , Hh^Fp       , Hh^Fp       , Gs^Fp       , Hh          , Hh          , Hh^Fp       , Hh^Fp       , Hh^Fp       , Hh^Fp       , Hh^Fp       , Gs^Fp       , Gs^Fp       , Gs^Fp       , Hh^Fp       , Hh^Fp       , Gs^Fp       , Gs^Fp       , Gs^Fp       
Hh^Fp       , Hh^Fms      , Hh          , Hh^Fp       , Hh^Fp       , Re          , Gs^Fp       , Re          , Gs^Fp       , Gs^Fp       , Gs^Fp       , Gs^Fp       , Re          , Gg          , Re          , Gs^Fp       , Gs^Fp       , Gs^Fp       , Gs^Fp       , Gs^Fp       , Gs^Fp       , Gs^Fp       , Gs^Fp       , Gs^Fp       , Gg^Ve       , Gs^Fp       , Gs^Fp       , Gs^Fp       , Hh          , Gs^Fp       , Gg^Ve       , Gs^Fp       
Mm          , Mm          , Chr         , Mm          , Mm          , Hh^Fp       , Hh          , Gg          , Gs^Fp       , Re          , Gs^Fp       , Re          , Gs^Fp       , Gs^Fp       , Gs^Fp       , Gs^Fp       , Re          , Hh^Fms      , Hh          , Gs^Fp       , Gs^Fp       , Gs^Fp       , Gs^Fp       , Gs^Fp       , Gs^Fp       , Gs^Fp       , Hh          , Gs^Fp       , Hh          , Gs^Fp       , Gs^Fp       , Gs^Fp       
Mm          , Mm          , Mm          , 2 Khr       , Chr         , Mm          , Mm          , Hh^Fp       , Gg          , Gs^Fp       , Gg          , Gs^Fp       , Gg         , Gs^Fp       , Gs^Fp       , Gs^Fp       , Re          , Hh          , Hh^Fms      , Hh          , Gs^Fp       , Gs^Fp       , Hh          , Hh^Fms      , Hh          , Hh^Fms      , Hh          , Hh          , Gs^Fp       , Hh          , Hh          , Hh          
Mm          , Mm          , Mm          , Mm          , Mm          , Mm          , Hh^Fp       , Hh^Fp       , Gs^Fp       , Gs^Fp       , Gs^Fp       , Ss          , Gg          , Gs^Fp       , Gs^Fp       , Gs^Fp       , Hh^Fms      , Hh          , Hh^Fms      , Hh^Fms      , Hh          , Hh          , Hh^Fms      , Hh          , Gs^Fp       , Gs^Fp       , Gs^Fp       , Gs^Fp       , Gs^Fp       , Hh          , Hh          , Hh          
Hh          , Hh          , Hh^Fp       , Hh^Fp       , Gs^Fp       , Hh^Fms      , Gs^Fp       , Hh^Fp       , Gs^Fp       , Gg          , Gs^Fp       , Gg          , Gs^Fp       , Gs^Fp       , Gs^Fp       , Re          , Hh^Fms      , Hh          , Gg^Ve       , Hh^Fms      , Hh^Fms      , Hh^Fms      , Hh^Fms      , Gs^Fp       , Gs^Fp       , Gs^Fp       , Gs^Fp       , Gs^Fp       , Gs^Fp       , Gs^Fp       , Gs^Fp       , Gs^Fp       
Hh          , Hh          , Gs^Fp       , Gg^Ve       , Gs^Fp       , Gs^Fp       , Gs^Fp       , Gs^Fp       , Gs^Fp       , Gs^Fp       , Gs^Fp       , Gs^Fp       , Gg^Ve       , Gs^Fp       , Re          , Re          , Hh^Fdf      , Hh^Fms      , Hh          , Hh          , Hh^Fms      , Hh          , Hh^Fms      , Hh          , Hh^Fms      , Gs^Fp       , Gs^Fp       , Gg^Ve       , Gs^Fp       , Gs^Fp       , Gs^Fp       , Gs^Fp       
Gs^Fp       , Gs^Fp       , Gs^Fp       , Gs^Fp       , Gs^Fp       , Gs^Fp       , Ss          , Gs^Fp       , Gs^Fp       , Gs^Fp       , Gs^Fp       , Gs^Fp       , Gs^Fp       , Gs^Fp       , Gs^Fp       , Hh^Fdf      , Gs^Fp       , Gs^Fp       , Gs^Fp       , Gs^Fp       , Gs^Fp       , Gs^Fp       , Gs^Fp       , Hh          , Gs^Fp       , Hh          , Gs^Fp       , Gs^Fp       , Ss          , Ss          , Gs^Fp       , Gs^Fp       
Gs^Fp       , Gs^Fp       , Gg^Ve       , Gs^Fp       , Gs^Fp       , Gs^Fp       , Gs^Fp       , Gs^Fp       , Gs^Fp       , Gs^Fp       , Gs^Fp       , Gs^Fp       , Gs^Fp       , Gs^Fp       , Gs^Fp       , Re          , Gs^Fp       , Gs^Fp       , Gs^Fp       , Gs^Fp       , Gs^Fp       , Gs^Fp       , Gs^Fp       , Gs^Fp       , Gs^Fp       , Gs^Fp       , Gs^Fp       , Gs^Fp       , Gs^Fp       , Ss          , Gs^Fp       , Gs^Fp       
Gs^Fp       , Gs^Fp       , Gg          , Gs^Fp       , Gs^Fp       , Gs^Fp       , Gs^Fp       , Gs^Fp       , Gs^Fp       , Gs^Fp       , Gs^Fp       , Gs^Fp       , Gs^Fp       , Gs^Fp       , Gg          , Re          , Re          , Gs^Fp       , Gs^Fp       , Gs^Fp       , Gs^Fp       , Gs^Fp       , Gs^Fp       , Gs^Fp       , Gs^Fp       , Gs^Fp       , Gs^Fp       , Gs^Fp       , Gs^Fp       , Ss          , Gs^Fp       , Gs^Fp       
