border_size=1
usage=map

Mm          , Mm          , Mm          , Mm          , Mm          , Mm          , Mm          , Mm          , Mm          , Mm          , Mm          , Mm          , Mm          , Mm          , Mm          , Mm          , Mm          , Mm          , Mm          , Mm          , Mm          , Mm          , Mm          , Mm          , Mm          , Mm          , Mm          , Mm          , Mm          
Hh^Fp       , Mm          , Mm          , Mm^Vc       , Mm          , Mm          , Mm          , Mm          , Mm          , Mm^Vc       , Mm          , Mm          , Mm          , Mm          , Hh          , Mm          , Mm          , Mm          , Mm          , Mm          , Mm          , Mm          , Mm          , Mm^Vc       , Mm          , Mm          , Hh^Fp       , Mm          , Mm          
Gg          , Hh^Fp       , Ss          , Hh          , Gg          , Hh^Fp       , Hh          , Mm          , Hh          , Mm          , Gg          , Mm          , Gg          , Hh^Fp       , Gg          , Hh^Fp       , Hh          , Mm          , Hh          , Mm          , Gg          , Hh          , Gg          , Hh          , Gg          , Hh^Fp       , Gg          , Hh^Fp       , Gg          
Ww          , Ww          , Ww          , Ww          , Ss          , Ss          , Ss          , Gg          , Ww          , Gg          , Ss          , Ww          , Ww          , Gg^Vc       , Ww          , Hh^Fp       , Gg          , Gg          , Ww          , Gg          , Ww          , Ww          , Ww          , Ww          , Ww          , Ww          , Ss          , Ww          , Ww          
Ww          , Ww          , Ww          , Ww          , Ww          , Ww          , Ww          , Ww          , Ww          , Ww          , Ww          , Ww          , Ww          , Ww          , Ww          , Ww          , Ww          , Ww          , Ww          , Ss          , Ww          , Ww          , Ww          , Ww          , Ww          , Ww          , Ww          , Ww          , Ww          
Ww          , Ww          , Ww          , Ww          , Ww          , Ww          , Ww          , Ww          , Ww          , Ww          , Ww          , Ww          , Ww          , Ww          , Ss          , Ww          , Ww          , Ww          , Ww          , Ww          , Ww          , Ww          , Ww          , Ww          , Ww          , Ww          , Ww          , Ww          , Ww          
Ww          , Ww          , Ww          , Ww          , Ww          , Ww          , Ww          , Ww          , Ww          , Ww          , Ww          , Ww          , Gg          , Gg          , Gg          , Ss          , Ww          , Ww          , Ww          , Ww          , Ww          , Ww          , Ww          , Ww          , Ww          , Ww          , Ww          , Ww          , Ww          
Ww          , Ww          , Ww          , Ww          , Ww          , Ww          , Ww          , Ww          , Ww          , Ww          , Ww          , Ww          , Gg          , Gg^Vc       , Gg          , Gg          , Ww          , Ww          , Ww          , Ww          , Ww          , Ww          , Ww          , Ww          , Ww          , Ww          , Ww          , Ww          , Ww          
Ww          , Ww          , Ww          , Ww          , Ww          , Ww          , Ww          , Ww          , Ww          , Ww          , Ww          , Ss          , Ww          , Gg          , Gg          , Gg          , Ww          , Ww          , Ww          , Ww          , Ww          , Ww          , Ww          , Ww          , Ww          , Ww          , Ww          , Ww          , Ww          
Ww          , Ww          , Ww          , Ww          , Ww          , Ww          , Ww          , Ww          , Ww          , Ww          , Ww          , Ww          , Ww          , Ww          , Ww          , Ww          , Ww          , Ww          , Ww          , Ww          , Ww          , Ww          , Ww          , Ww          , Ww          , Ww          , Ww          , Ww          , Ww          
Ww          , Ww          , Ww          , Ww          , Ss          , Ww          , Ww          , Ww          , Ww          , Ww          , Ww          , Ww          , Ww          , Ww          , Ww          , Ww          , Ss          , Ww          , Ss          , Ww          , Ww          , Ww          , Ww          , Ww          , Ww          , Ww          , Ww          , Ww          , Ww          
Gg          , Ss          , Gg          , Ss          , Hh^Fp       , Ss          , Gg          , Ww          , Gg          , Ww          , Ss          , Ww          , Ss          , Ww          , Ww          , Ww          , Gg          , Ss          , Gg          , Ww          , Ss          , Ww          , Ww          , Ww          , Ss          , Ww          , Ss          , Ww          , Ss          
Hh          , Hh^Fp       , Hh^Fp       , Hh^Fmf      , Hh^Fp       , Hh^Fp       , Hh          , Hh^Fmf      , Hh^Fp       , Gg          , Gg          , Ss          , Gg          , Gg          , Gg          , Hh^Fp       , Hh          , Hh^Fp       , Hh          , Hh^Fp       , Hh          , Hh^Fp       , Hh          , Hh^Fmf      , Hh          , Gg          , Gg          , Ss          , Gg          
Mm          , Hh^Fp       , Mm          , Mm          , Mm          , Mm          , Mm          , Hh^Fmf      , Hh          , Gg          , Gg          , Gg          , Gg          , Gg          , Gg          , Hh^Fmf      , Hh^Fp       , Hh^Fp       , Mm          , Hh^Fmf      , Mm          , Hh^Fmf      , Mm          , Mm          , Mm          , Hh^Fdf      , Hh^Fmw      , Hh^Fmw      , Hh^Fdf      
Mm          , Mm          , Mm          , Mm          , Mm          , Mm          , Mm          , Mm          , Hh          , Hh^Fp       , Gg          , Gg^Vc       , Gg          , Gg          , Gg          , Hh^Fp       , Hh^Fp       , Hh^Fp       , Mm          , Mm          , Mm          , Mm^Vc       , Mm          , Mm          , Mm          , Mm          , Mm          , Mm          , Hh^Fmw      
Mm          , Mm          , Mm          , Mm^Vc       , Mm          , Mm          , Mm          , Mm          , Mm          , Hh          , Gg          , Gg          , Hh^Fmf      , Hh          , Hh          , Hh^Fmf      , Hh          , Mm          , Mm          , Mm          , Mm          , Mm          , Mm          , Mm          , Mm          , Mm          , Mm          , Mm          , Mm          
Mm          , Mm          , Mm          , Mm          , Mm          , Mm          , Mm          , Mm          , Mm          , Hh          , Gg          , Gg          , Hh^Fmf      , Hh^Fmf      , Mm          , Hh          , Hh^Fp       , Mm          , Mm          , Mm          , Mm          , Mm          , Mm          , Mm          , Mm^Vc       , Mm          , Mm          , Mm          , Mm          
Mm          , Mm^Vc       , Mm          , Mm          , Mm          , Mm          , Mm          , Mm          , Mm          , Hh          , Hh^Fp       , Hh^Fp       , Hh          , Hh          , Mm          , Hh^Fp       , Mm          , Mm          , Mm          , Mm          , Mm          , Mm          , Mm          , Mm          , Mm          , Mm          , Mm          , Mm          , Mm          
Mm          , Mm          , Mm          , Mm          , Mm          , Mm          , Mm          , Mm          , Mm          , Hh          , Gg          , Gg          , Gg          , Hh^Fmf      , Hh^Fp       , Hh          , Mm          , Mm          , Mm          , Mm          , Mm          , Mm          , Mm          , Mm          , Mm          , Mm          , Mm          , Mm          , Mm          
Mm          , Mm          , Mm          , Mm          , Mm          , Mm          , Mm^Vc       , Mm          , Mm          , Hh^Fp       , Hh          , Gg          , Hh          , Gg^Vc       , Hh^Fp       , Hh^Fmf      , Hh          , Mm          , Mm          , Mm^Vc       , Mm          , Mm          , Mm          , Mm          , Mm          , Mm          , Mm          , Mm          , Mm          
Mm          , Mm          , Mm          , Mm          , Mm          , Mm          , Mm          , Mm          , Mm          , Hh^Fp       , Gg          , Hh^Fmf      , Mm          , Hh          , Hh^Fmf      , Hh          , Mm          , Mm          , Mm          , Mm          , Mm          , Mm          , Mm          , Mm          , Mm          , Mm          , Mm          , Mm          , Mm          
Mm          , Mm^Vc       , Mm          , Mm          , Mm          , Mm          , Mm          , Mm          , Mm          , Hh          , Hh^Fmf      , Hh          , Hh          , Mm          , Hh          , Hh          , Mm          , Mm          , Mm          , Mm          , Mm          , Mm          , Mm          , Mm          , Mm          , Mm          , Mm          , Mm^Vc       , Mm          
Mm          , Mm          , Mm          , Mm          , Mm          , Mm          , Mm          , Mm          , Mm          , Hh^Fp       , Hh^Fp       , Gg          , Mm          , Mm          , Hh          , Hh^Fmf      , Hh^Fmf      , Mm          , Mm          , Mm          , Mm          , Ch          , Chr         , Mm          , Mm          , Mm          , Mm          , Mm          , Mm          
Mm          , Mm          , Mm          , Mm          , Mm          , Mm          , Mm          , Mm          , Hh^Fp       , Hh^Fp       , Hh^Fp       , Hh          , Hh^Fp       , Hh          , Gg          , Hh          , Hh^Fmf      , Mm          , Mm          , Mm          , Mm          , Chr         , 3 Khr       , Chr         , Ch          , Mm          , Mm          , Mm          , Mm          
Mm          , Mm          , Mm          , Mm          , Mm          , Mm          , Mm          , Mm          , Mm          , Hh          , Hh^Fp       , Gg          , Gg          , Gg          , Gg          , Gg          , Hh^Fp       , Hh^Fmf      , Hh          , Mm          , Mm          , Chr         , Chr         , Chr         , Mm          , Mm          , Mm          , Mm          , Mm          
Mm          , Mm^Vc       , Mm          , Mm          , Mm          , Mm^Vc       , Mm          , Mm          , Mm          , Hh          , Hh^Fp       , Gg          , Gg          , Gg          , Gg          , Gg          , Gg          , Gg          , Hh^Fp       , Hh          , Mm          , Mm          , Mm          , Chr         , Mm          , Mm          , Mm          , Mm          , Mm          
Mm          , Mm          , Mm          , Mm          , Mm          , Mm          , Mm          , Mm          , Mm          , Hh          , Hh^Fmf      , Hh^Fmf      , Gg          , Hh^Fp       , Gg          , Gg          , Gg          , Gg          , Hh          , Hh^Fmf      , Mm          , Mm          , Mm          , Mm          , Mm          , Mm          , Mm^Vc       , Mm          , Mm          
Mm          , Mm          , Mm          , Mm          , Mm          , Mm          , Mm          , Mm          , Hh^Fp       , Hh          , Hh          , Gg          , Gg          , Hh^Fp       , Hh^Fp       , Gg          , Gg          , Gg          , Hh^Fp       , Hh          , Mm          , Mm          , Mm          , Mm          , Mm          , Mm          , Mm          , Mm          , Mm          
Mm          , Mm          , Ch          , Mm          , Ch          , Mm          , Mm          , Mm          , Mm          , Hh^Fp       , Hh^Fp       , Gg          , Hh^Fp       , Hh^Fp       , Hh^Fp       , Hh^Fp       , Gg          , Gg          , Hh          , Hh          , Mm          , Mm          , Mm          , Mm          , Mm          , Mm          , Mm          , Mm          , Mm          
Mm          , Mm          , Chr         , Chr         , Chr         , Mm          , Mm          , Mm          , Mm          , Hh          , Hh^Fmf      , Gg          , Gg          , Gg          , Gg^Vc       , Gg          , Gg          , Gg          , Hh^Fmf      , Hh          , Mm          , Mm^Vc       , Mm          , Mm          , Mm^Vc       , Mm          , Mm          , Mm          , Mm          
Mm          , Mm          , Chr         , 2 Khr       , Chr         , Mm          , Mm          , Mm^Vc       , Mm          , Mm          , Hh          , Gg          , Gg          , Gg          , Gg          , Gg          , Gg          , Gg          , Gg          , Hh          , Mm          , Mm          , Mm          , Mm          , Mm          , Mm          , Mm          , Mm          , Mm          
Mm          , Mm          , Mm          , Chr         , Mm          , Mm          , Mm          , Mm          , Mm          , Hh          , Hh^Fmf      , Gg          , Gg          , Gg          , Hh^Fp       , Hh^Fp       , Hh^Fp       , Hh^Fmf      , Hh^Fp       , Hh^Fp       , Hh^Fp       , Mm          , Mm          , Mm          , Mm          , Mm          , Mm          , Mm          , Mm          
Mm          , Mm          , Mm          , Mm          , Mm          , Mm          , Mm          , Mm          , Mm          , Hh^Fp       , Hh^Fp       , Hh          , Gg          , Gg          , Hh^Fp       , Gg          , Gg          , Gg          , Hh^Fmf      , Hh          , Mm          , Mm          , Mm          , Mm          , Mm          , Mm          , Mm          , Mm          , Mm          
Mm          , Mm          , Mm          , Mm          , Mm          , Mm          , Mm          , Mm          , Hh          , Hh          , Hh^Fmf      , Hh^Vc       , Gg          , Gg          , Ce          , Gg          , Ce          , Gg          , Hh          , Hh          , Mm          , Mm          , Mm^Vc       , Mm          , Hh          , Mm          , Mm          , Mm          , Mm          
Mm          , Mm          , Mm          , Mm          , Mm          , Mm          , Mm          , Mm^Vc       , Mm          , Hh^Fp       , Hh          , Hh^Fp       , Hh          , Ce          , Ce          , Ce          , Ce          , Hh^Fmf      , Hh^Fp       , Hh^Fmf      , Mm          , Mm          , Mm          , Mm          , Mm          , Mm          , Mm          , Mm          , Mm          
Mm          , Mm          , Mm          , Mm^Vc       , Mm          , Mm          , Mm          , Mm          , Mm          , Mm          , Mm          , Hh^Fp       , Hh^Fmf      , Hh^Fmf      , Ce          , 1 Ke        , Ce          , Gg          , Hh^Fmf      , Hh          , Mm          , Mm          , Mm          , Mm          , Mm          , Mm          , Mm          , Mm          , Mm          
Mm          , Mm          , Mm          , Mm          , Mm          , Mm          , Mm          , Mm          , Mm          , Mm          , Mm          , Hh          , Hh^Fmf      , Ce          , Gg          , Ce          , Gg          , Ce          , Hh^Fp       , Hh          , Mm          , Mm          , Mm          , Mm          , Mm          , Mm          , Mm          , Mm          , Mm          
Mm          , Mm          , Mm          , Mm          , Mm          , Mm          , Mm          , Mm          , Mm          , Mm          , Mm          , Hh          , Hh          , Gg          , Gg          , Gg          , Gg          , Gg          , Hh          , Mm          , Mm          , Mm          , Mm          , Mm          , Mm          , Mm          , Mm          , Mm          , Mm          
