border_size=1
usage=map

Gg          , Gg          , Gg          , Gg          , Gg          , Gg          , Gg          , Gg          , Gg          , Gg          , Gg          , Gg          , Gg          , Gg          , Gg          , Re          , Gg          , Gg          , Gg          , Gg          , Gg          , Gg          , Gg          , Gg          , Gg          , Gg          , Gg          
Ss          , Gg          , Gg          , Gg          , Ss          , Gg          , Ss          , Gg          , Gg^Vh       , Gg          , Gg          , Ss          , Gs^Fp       , Gs^Fp       , Gs^Fp       , Re          , Re          , Gg^Vh       , Gg          , Gg          , Ce          , Ce          , Ce          , Ss          , Gs^Fp       , Ss          , Gg          
Ww          , Ss          , Gg          , Gg          , Ss          , Ss          , Gg          , Gg          , Ss          , Gg          , Gg          , Gg          , Gg          , Gg          , Re          , Re          , Gg          , Re          , Re          , Ss          , Ce          , 1 Ke        , Ce          , Ss          , Gg          , Ss^Vhs      , Gg          
Ss          , Ww          , Ww          , Ss          , Ss          , Gg          , Ss          , Gg          , Ss          , Gg          , Gg          , Gg          , Ss          , Re          , Gg          , Gg          , Ss          , Gg          , Ss          , Re          , Gg          , Ce          , Gg          , Gg          , Ss          , Ss          , Ss          
Gg          , Ss          , Ss          , Ww          , Ww          , Ss^Vhs      , Ww          , Ww          , Ww          , Ss          , Ww          , Ss          , Ww          , Re          , Gg          , Ss^Vhs      , Ss          , Gg          , Ss          , Re          , Re          , Gg          , Ww          , Ss          , Ww          , Ww          , Ww          
Ss          , Ss          , Gg          , Ss          , Ss          , Ww          , Ss          , Ss          , Ss          , Ww          , Ss          , Ww          , Ss          , Ww^Bw|      , Ww          , Ss          , Ww          , Ww          , Ww          , Ww          , Ww^Bw|      , Ww          , Ss          , Ww          , Ss^Vhs      , Ss          , Ss          
Ss          , Gg          , Gg^Vh       , Gg          , Gg          , Ss^Vhs      , Ss          , Gg          , Gg          , Ss          , Gg          , Ss          , Re          , Re          , Ss          , Ww          , Ss          , Ss          , Ss          , Ss          , Re          , Ss          , Gs^Fp       , Ss          , Gs^Fp       , Gg          , Gg          
Gg          , Gg          , Gg          , Gg          , Gg          , Ss          , Gs^Fp       , Gg          , Gs^Fp       , Gs^Fp       , Gs^Fp       , Re          , Ss          , Ss          , Ww          , Ww          , Ss          , Gg          , Gg          , Gg          , Re          , Gg          , Gg          , Gs^Fp       , Ss          , Gg          , Ss          
Re          , Ss          , Re          , Ss          , Gg          , Gs^Fp       , Ss          , Gg          , Gg          , Gg          , Ss          , Re          , Ss          , Ww          , Ss          , Ss          , Gg          , Gg          , Re          , Re          , Gg          , Gg          , Ss          , Gg          , Gg          , Gg          , Gg          
Re          , Re          , Ss          , Re          , Re          , Ss          , Re          , Re          , Re          , Ss          , Re          , Re          , Ss^Vhs      , Ww          , Ss          , Gg          , Gg          , Gg          , Re          , Ss          , Ss          , Gg^Vh       , Ss          , Gg          , Ss          , Gg          , Ss          
Gg          , Ss          , Gg          , Gg          , Ss          , Re          , Gg          , Ss          , Ss          , Re          , Ss          , Ss          , Ww          , Ww          , Ss          , Gg          , Gg^Vh       , Gg          , Re          , Re          , Re          , Gg          , Gg          , Gg          , Gg          , Gg          , Gg          
Gg          , Gg          , Ss          , Gg          , Ss          , Gg          , Ss          , Gg          , Ss^Vhs      , Ss          , Ww          , Ww          , Ww          , Ss          , Ss          , Gg          , Re          , Re          , Gg          , Gg          , Gg          , Re          , Re          , Ss          , Ss          , Gg          , Ss          
Ss          , Ss          , Ww          , Ss          , Ww          , Ss          , Ww          , Ss          , Ww          , Ww          , Ss^Vhs      , Ss          , Ss          , Ww          , Ww          , Ss          , Re          , Ss          , Ss          , Gg          , Ss          , Ss          , Re          , Ss^Vhs      , Ww          , Ss          , Ww          
Ww          , Ww          , Ss^Vhs      , Ww          , Chs         , Ww          , Ww          , Ww          , Ss          , Ss          , Ss          , Gg          , Ss          , Ss          , Re          , Ww^Bw/      , Ww          , Ss          , Ww          , Ww          , Ww          , Ww          , Ww          , Ww^Bw\      , Re          , Ww          , Ss          
Ss          , Ss          , Gs^Fp       , Ss          , Ss          , Ss          , Ww          , Ss          , Ss          , Ss          , Ss          , Ss          , Gg          , Re          , Ss          , Ss          , Ss          , Ww          , Ss          , Ss          , Ss          , Ss^Vhs      , Ss          , Gg          , Re          , Ss^Vhs      , Gg          
Ss          , Ss          , Gs^Fp       , Ss          , Ss^Vhs      , Ss          , Ss          , Ww          , Ss          , Ss^Vhs      , Gs^Fp       , Gs^Fp       , Gg          , Re          , Gs^Fp       , Gg          , Ss^Vhs      , Ww          , Ss          , Gg          , Gg          , Gs^Fp       , Gs^Fp       , Gg          , Re          , Ss          , Gg          
Ss          , Gs^Fp       , Gg          , Gg          , Gg          , Ss          , Gg          , Ww          , Ww          , Ss          , Gg          , Gg          , Ss          , Re          , Gg          , Gs^Fp       , Ss          , Ww          , Ww          , Gg          , Ss          , Gs^Fp       , Gg          , Re          , Ss          , Re          , Ss          
Gg          , Gg          , Gg          , Gg          , Gg          , Gg          , Ss          , Ss          , Ww          , Ss          , Re          , Re          , Re          , Re          , Gg          , Gs^Fp       , Gg          , Ss          , Ww          , Ss          , Gg          , Gg          , Re          , Re          , Re          , Re          , Re          
Re          , Re          , Re          , Ss^Vhs      , Re          , Gg          , Re          , Ss          , Re          , Ww^Bw/      , Gg          , Ss          , Re          , Re          , Ss          , Gg          , Ss          , Ss          , Ss          , Ww          , Ww^Bw/      , Re          , Gg          , Ss          , Ss          , Ss          , Gg          
Gg          , Ss          , Gg          , Re          , Gg          , Re          , Gg          , Re          , Ss          , Ww          , Ss^Vhs      , Gg          , Re          , Gg          , Gg          , Gg          , Gg          , Gg          , Re          , Re          , Ww          , Ss          , Gg          , Gg          , Gg          , Gg          , Gg          
Gg          , Gg          , Chs         , Gg          , Gg          , Gg          , Gg          , Ss          , Ww          , Ww          , Ss          , Gg          , Re          , Ss          , Gg          , Ss          , Ss          , Re          , Ss          , Ss^Vhs      , Ss          , Ww          , Ss          , Gg          , Gg^Vh       , Gg          , Ss          
Gg          , Chs         , 3 Khs       , Chs         , Ss          , Gg          , Ss          , Ss^Vhs      , Ww          , Gg          , Gg          , Gg          , Re          , Gg          , Gg          , Gg          , Gg          , Re          , Gg          , Gg          , Ss          , Ww          , Ss          , Gg          , Gg          , Gg          , Gg          
Ss          , Chs         , Chs         , Chs         , Gg          , Ss          , Ss          , Ww          , Ss          , Ss          , Gg          , Gs^Fp       , Ss          , Re          , Ss^Vhs      , Gg          , Gg          , Re          , Gg          , Gg          , Ss          , Ww          , Ww          , Ss          , Gg          , Ss          , Ss          
Gg          , Gg          , Ss          , Gg          , Ss          , Ss          , Ss          , Ww          , Ss          , Gg          , Gs^Fp       , Gs^Fp       , Ss          , Re          , Ss          , Ss          , Ss          , Re          , Chs         , Chs         , Chs         , Ss          , Ss          , Ww          , Ss          , Ss          , Ww          
Gg          , Ss          , Gs^Fp       , Gs^Fp       , Ss          , Chs         , Ss^Vhs      , Ww          , Ss          , Gg          , Gg          , Gs^Fp       , Gg          , Re          , Re          , Gg          , Re          , Re          , Chs         , 2 Khs       , Chs         , Gg          , Ss^Vhs      , Ww          , Ww          , Ww          , Ss          
Gg          , Gs^Fp       , Gg          , Gg          , Gg          , Ss          , Ss          , Ww          , Ss          , Gg          , Gg          , Gg          , Gg          , Re          , Ss          , Re          , Ss          , Gg          , Gg          , Chs         , Gg          , Ss          , Ss          , Ww          , Ss          , Ss          , Ss          
Ss          , Ss          , Ss          , Ss          , Ss          , Ss          , Ww          , Ww          , Ss          , Gg          , Ss          , Ss          , Ss          , Re          , Gg          , Gg          , Gg          , Ss          , Gg          , Gg          , Ss          , Ss          , Ww          , Ww          , Ss          , Chs         , Ss          
