border_size=1
usage=map

Mm          , Mm          , Mm          , Mm          , Mm          , Mm          , Mm          , Mm          , Hh          , Hh^Fp       , Hh^Fp       , Hh^Fp       , Hh^Fp       , Hh          , Mm          , Mm          , Ww          , Mm          , Mm          , Mm          , Mm          , Mm          , Mm^Vc       , Mm          , Ww          , Ww          , Ww          , Ww          , Ww          , Ww          , Ww          , Mm          
Mm          , Mm          , Mm          , Hh^Fms      , Hh^Fms      , Mm          , Mm          , Hh^Fms      , Hh^Fdf      , Hh^Fms      , Hh^Fp       , Hh^Fp       , Hh^Fp       , Hh^Fdf      , Mm^Vc       , Mm          , Mm          , Ww          , Ww          , Mm          , Hh^Fdf      , Hh^Fms      , Hh^Fms      , Mm          , Mm          , Ww          , Wo          , Wo          , Wo          , Wo          , Wo          , Ww          
Mm          , Mm          , Mm          , Hh          , Hh^Fdf      , Hh          , Hh          , Rr^Vd       , Mm          , Hh^Fdf      , Gg          , Rr^Vd       , Gg          , Hh^Fms      , Hh^Fdf      , Mm          , Mm          , Mm          , Mm          , Ww          , Ww          , Ww          , Ww          , Mm          , Ww          , Ww          , Wo          , Mm          , Mm          , Wo          , Wo          , Ww          
Mm          , Mm^Vc       , Mm          , Hh^Fms      , Ch          , Ch          , Ch          , Hh          , Mm          , Hh^Fdf      , Hh^Fdf      , Hh^Fdf      , Gs^Fdf      , Hh^Fp       , Hh^Fms      , Mm          , Mm          , Mm^Vc       , Mm          , Mm          , Mm          , Hh^Fms      , Gs^Fp       , Ww          , Mm          , Ww          , Wo          , Mm          , Wo          , Wo          , Ww          , Ww          
Mm          , Mm          , Hh^Fms      , Hh          , Ch          , 2 Kh        , Ch          , Mm          , Hh          , Hh^Fdf      , Hh^Fms      , Gg          , Gg          , Gg          , Gs^Fdf      , Hh^Fms      , Hh^Vc       , Mm          , Mm          , Mm          , Mm          , Hh^Fdf      , Hh^Fdf      , Hh^Fms      , Mm          , Ww          , Wo          , Mm          , Wo          , Wo          , Ww          , Mm          
Mm          , Mm          , Hh^Fms      , Hh          , Hh^Fdf      , Ch          , Mm          , Mm          , Hh^Fdf      , Mm          , Mm          , Hh^Fms      , Hh^Fdf      , Hh^Fp       , Gs^Fdf      , Gg          , Hh^Fms      , Mm          , Mm          , Gg          , Mm          , Hh^Fdf      , Gg          , Mm          , Hh          , Ww          , Wo          , Wo          , Wo          , Wo          , Ww          , Mm          
Mm          , Mm          , Mm          , Mm          , Hh^Fdf      , Mm          , Hh^Fdf      , Mm          , Mm          , Mm          , Mm          , Hh^Fdf      , Hh^Fdf      , Hh^Fdf      , Hh          , Gg          , Gs^Fdf      , Hh^Fdf      , Ce          , Ce          , Ce          , Gg          , Hh^Fms      , Hh^Fms      , Ww          , Ww          , Wo          , Wo          , Wo          , Wo          , Ww          , Mm          
Mm          , Mm          , Mm          , Hh^Fms      , Mm          , Rr^Vd       , Hh^Fdf      , Mm          , Hh^Fdf      , Rr^Vd       , Hh^Fdf      , Mm          , Hh^Fdf      , Hh^Fms      , Gg          , Gg          , Hh^Fdf      , Gg          , Ce          , 3 Ke        , Ce          , Mm          , Mm          , Ww          , Ww          , Wo          , Ww          , Wo          , Ww          , Ww          , Ww          , Mm          
Mm          , Mm          , Mm          , Mm          , Mm          , Hh^Fms      , Mm          , Hh^Fdf      , Hh^Fdf      , Mm          , Mm          , Mm          , Hh^Fms      , Gg          , Hh^Fms      , Hh          , Hh^Fdf      , Gg          , Mm          , Ce          , Mm          , Mm          , Mm          , Hh          , Mm          , Ww          , Hh^Fms      , Ww          , Ww          , Ww          , Mm          , Mm          
Mm          , Mm          , Mm          , Mm          , Mm          , Hh^Fms      , Hh^Fdf      , Hh          , Mm          , Mm          , Mm          , Mm          , Hh^Fms      , Gg          , Hh          , Hh^Fms      , Hh^Fms      , Hh^Fdf      , Mm          , Mm          , Mm          , Hh          , Mm^Vc       , Mm          , Hh          , Hh^Fms      , Ww          , Ww          , Ww          , Hh^Fms      , Mm          , Mm          
Mm          , Mm^Vc       , Mm          , Mm          , Mm          , Mm          , Mm          , Mm          , Hh^Fms      , Hh^Fdf      , Hh^Fdf      , Hh^Fms      , Hh          , Hh          , Hh          , Hh          , Hh^Fms      , Mm          , Mm          , Mm          , Hh^Fms      , Hh          , Mm          , Mm          , Mm          , Hh^Fms      , Mm          , Ww          , Ww          , Mm          , Mm^Vc       , Mm          
Mm          , Mm          , Ww          , Mm          , Ww          , Ww          , Hh          , Hh^Fdf      , Mm          , Hh^Fms      , Mm          , Hh^Fms      , Mm          , Mm          , Mm          , Mm          , Hh          , Mm          , Hh^Fms      , Hh^Fms      , Gg          , Hh          , Hh          , Mm          , Mm          , Mm          , Mm          , Mm          , Mm          , Ww          , Mm          , Mm          
Mm          , Ww          , Ww          , Ww          , Ww          , Ww          , Hh^Fdf      , Mm          , Mm^Vc       , Mm          , Mm          , Mm          , Hh          , Hh          , Hh          , Hh^Vc       , Hh^Fms      , Hh          , Gg          , Gg          , Gs^Fdf      , Gs^Fdf      , Hh^Fms      , Mm          , Mm          , Mm          , Mm^Vc       , Mm          , Mm          , Ww          , Ww          , Mm          
Mm          , Ww          , Ww          , Ww          , Ww          , Ww          , Ww          , Hh^Fdf      , Hh^Fds      , Hh^Fds      , Mm          , Hh          , Mm^Vc       , Mm          , Mm          , Mm          , Hh^Fms      , Gg          , Hh^Fdf      , Hh^Fms      , Gs^Fdf      , Gs^Fdf      , Hh^Fms      , Mm          , Mm          , Mm          , Mm          , Mm          , Mm          , Mm          , Mm          , Ww          
Mm          , Mm          , Mm          , Mm          , Mm          , Hh          , Mm          , Mm          , Hh^Fds      , Hh^Fds      , Mm          , Mm          , Hh          , Mm          , Hh          , Mm          , Mm          , Hh^Fdf      , Mm          , Hh^Fdf      , Hh^Fdf      , Gs^Fdf      , Gs^Fp       , Hh^Vc       , Mm          , Mm          , Mm          , Mm          , Mm          , Mm          , Mm^Vc       , Mm          
Mm          , Mm          , Mm          , Mm^Vc       , Mm          , Mm          , Mm          , Hh          , Hh^Fds      , Hh^Fds      , Mm          , Mm          , Mm          , Mm          , Hh          , Mm          , Hh          , Mm          , Mm          , Hh^Fdf      , Gs^Fp       , Gg          , Gs^Fp       , Hh^Fms      , Hh          , Mm          , Mm          , Mm          , Mm          , Mm          , Mm          , Mm          
Hh^Fp       , Hh^Fp       , Mm          , Mm          , Mm          , Mm          , Mm          , Hh^Fds      , Hh^Fdf      , Hh^Fdf      , Hh^Fds      , Mm          , Mm          , Mm          , Mm          , Mm          , Mm          , Mm          , Hh^Fms      , Hh          , Gg          , Gg          , Gg          , Gs^Fp       , Hh          , Hh          , Mm          , Mm          , Mm          , Mm          , Mm          , Mm          
Mm          , Hh^Fp       , Mm          , Mm          , Mm          , Mm          , Mm          , Mm          , Hh          , Hh^Fdf      , Hh^Fdf      , Hh^Fdf      , Hh^Fds      , Mm          , Mm          , Mm          , Mm^Vc       , Mm          , Hh          , Gs^Fp       , Gs^Fp       , Gg          , Ce          , Ce          , Ce          , Hh          , Hh^Fms      , Mm          , Mm          , Mm          , Mm^Vhh      , Mm          
Mm          , Hh^Fp       , Mm          , Mm          , Mm          , Hh^Fp       , Hh^Fp       , Mm          , Ww          , Ww          , Hh^Fdf      , Hh^Vc       , Hh          , Hh^Fds      , Hh^Fds      , Mm          , Mm          , Mm          , Hh          , Hh          , Gs^Fp       , Gg          , Ce          , 1 Ke        , Ce          , Hh          , Hh          , Hh^Fms      , Mm          , Mm          , Mm          , Mm          
Mm          , Mm          , Mm          , Mm^Vc       , Mm          , Mm          , Ww          , Ww          , Ww          , Hh^Fds      , Hh^Fds      , Hh^Fdf      , Hh^Fds      , Hh^Fds      , Hh^Fds      , Mm          , Hh^Fds      , Mm          , Hh^Fdf      , Hh^Fms      , Hh^Fms      , Gg          , Gs^Fp       , Ce          , Hh^Fdf      , Gs^Fp       , Hh          , Hh          , Mm^Vhh      , Mm          , Mm          , Mm          
Mm          , Mm          , Mm          , Mm          , Ww          , Ww          , Ww          , Ww          , Ww          , Ww          , Hh          , Hh          , Hh^Fds      , Hh^Fds      , Hh          , Mm          , Mm          , Hh^Fds      , Hh^Fds      , Hh^Fms      , Mm          , Hh          , Hh^Fms      , Hh          , Hh^Fms      , Hh^Fdf      , Hh          , Hh^Fms      , Hh          , Mm          , Mm          , Mm          
Hh^Fp       , Hh^Fp       , Mm          , Mm          , Ww          , Ww          , Ww          , Ww          , Ww          , Ww          , Mm          , Mm          , Mm          , Hh          , Mm          , Mm          , Mm          , Mm          , Mm          , Mm          , Hh^Fp       , Mm          , Mm          , Hh^Fms      , Mm          , Mm          , Mm          , Hh          , Hh^Fms      , Hh^Fms      , Hh          , Mm          
Hh^Fp       , Mm          , Mm          , Mm          , Mm          , Ww          , Hh^Fp       , Hh^Fp       , Mm          , Mm          , Mm          , Mm          , Mm          , Mm          , Mm          , Mm          , Mm          , Mm          , Mm          , Mm          , Hh^Fp       , Mm          , Hh^Fp       , Mm          , Hh^Fp       , Hh^Fdf      , Mm          , Mm          , Mm          , Hh          , Mm          , Mm          
Gg          , Mm          , Mm          , Mm          , Mm          , Mm          , Mm          , Mm          , Mm          , Mm^Vc       , Mm          , Mm          , Mm          , Mm          , Mm          , Mm          , Mm          , Mm          , Mm          , Mm          , Mm          , Hh^Fp       , Mm          , Mm          , Mm          , Mm          , Mm          , Mm          , Mm          , Mm          , Mm          , Mm          
