border_size=1
usage=map

Ms          , Ms          , Ha^Fpa      , Ms          , Ms          , Mm          , Ww          , Mm          , Mm          , Mm          , Ms          , Mm          , Mm          , Mm          , Mm          , Mm          , Mm          , Mm          , Mm          , Mm          , Mm          , Mm          , Ms          , Mm          , Mm          , Ha^Fpa      , Mm          , Mm          , Hh^Fdf      , Mm          , Hh^Fdf      , Hh^Fdf      , Hh^Fdf      , Hh^Fdf      , Hh^Fdf      , Hh^Fdf      , Re          
Mm          , Mm          , Ms          , Mm          , Ha^Fpa      , Mm          , Mm          , Ww          , Ww          , Mm          , Mm          , Ha^Fpa      , Mm          , Mm          , Mm          , Mm          , Mm          , Mm          , Mm          , Ha^Fpa      , Hh^Fdf      , Mm          , Mm          , Ha^Fpa      , Hh^Fmw      , Mm          , Hh^Fdf      , Hh^Fdf      , Hh^Fdf      , Hh^Fdf      , Re^Vct      , Hh^Fdf      , Gg          , Hh^Fdf      , Re          , Re          , Gs^Fp       
Mm          , Mm          , Mm          , Mm          , Mm          , Mm          , Hh^Fmw      , Mm          , Hh^Fdw      , Ww          , Ww          , Mm          , Mm          , Mm          , Hh^Fdf      , Hh^Fdw      , Hh^Fdf      , Mm          , Hh^Fdw      , Mm          , Gg^Ve       , Hh^Fdf      , Hh^Fdw      , Hh^Fdw      , Hh^Fmw      , Hh^Fmw      , Hh^Fmw      , Ce          , Ce          , Gs^Fp       , Gg          , Gs^Fp       , Re          , Re          , Gg^Ve       , Gs^Fp       , Ww          
Hh^Fmw      , Hh^Fmw      , Hh^Fmw      , Hh^Fmw      , Hh^Fmw      , Hh^Fmw      , Hh^Fdw      , Hh^Fdw      , Hh^Fmw      , Hh^Fdw      , Ww          , Ww          , Hh^Fdf      , Hh^Fdf      , Gg^Ve       , Gs^Fp       , Gs^Fp       , Hh^Fdf      , Gs^Fp       , Gs^Fp       , Gs^Fp       , Gs^Fp       , Gs^Fp       , Re^Vct      , Gg          , Gs^Fp       , Ce          , Ce          , 3 Ke        , Ce          , Re          , Re          , Gs^Fp       , Gs^Fp       , Ww          , Ww          , Ww          
Gs^Fp       , Gg^Ve       , Gs^Fp       , Hh^Fdf      , Gs^Fp       , Hh^Fmw      , Gg^Ve       , Hh^Fdf      , Gs^Fp       , Hh^Fdw      , Hh^Fdf      , Ww          , Ww          , Hh^Fdf      , Gs^Fp       , Gs^Fp       , Gs^Fp       , Gs^Fp       , Aa^Fpa      , Gs^Fp       , Aa^Fpa      , Gs^Fp       , Gs^Fp       , Aa^Fpa      , Aa^Fpa      , Gg          , Re          , Ce          , Ce          , Ce          , Gs^Fp       , Gs^Fp       , Ww          , Ww          , Ww          , Ww          , Gs^Fp       
Gs^Fp       , Gs^Fp       , Gs^Fp       , Gs^Fp       , Gs^Fp       , Gs^Fp       , Gs^Fp       , Gs^Fp       , Gg^Fet      , Gs^Fp       , Gs^Fp       , Ww          , Ww          , Ww          , Ww          , Gs^Fp       , Gs^Fp       , Gs^Fp       , Gs^Fp       , Gs^Fp       , Re          , Gs^Fp       , Re          , Re          , Re          , Re          , Gg          , Ce          , Gs^Fp       , Gg          , Ww          , Ww          , Ww          , Ww          , Hh^Fmf      , Gs^Fp       , Gs^Fp       
Gs^Fp       , Gs^Fp       , Ce          , Gs^Fp       , Gs^Fp       , Ha^Fpa      , Gs^Fp       , Gs^Fp       , Hh^Fmw      , Hh^Fdf      , Hh^Fmw      , Gs^Fp       , Ww          , Ww          , Ww          , Gs^Fp       , Gs^Fp       , Gs^Fp       , Re          , Re          , Gs^Fp       , Re          , Gg^Fet      , Gs^Fp       , Hh^Fmw      , Re^Vct      , Hh^Fmw      , Hh^Fmw      , Ww          , Ww          , Ww          , Ww          , Gs^Fp       , Hh^Fmf      , Gs^Fp       , Hh^Fmw      , Gs^Fp       
Gs^Fp       , Ce          , 1 Ke        , Ce          , Gs^Fp       , Hh^Fmf      , Hh^Fmf      , Hh^Fdw      , Hh^Fdw      , Hh^Fdw      , Hh^Fmw      , Gg^Ve       , Gs^Fp       , Ww          , Ww          , Ww          , Ww^Bw/      , Re          , Gs^Fp       , Gs^Fp       , Gg^Ve       , Gs^Fp       , Gs^Fp       , Gs^Fp       , Hh^Fmw      , Hh^Fdw      , Ww          , Ww          , Ww          , Ww          , Gs^Fp       , Gs^Fp       , Gg^Fet      , Gs^Fp       , Hh^Fmw      , Gg^Ve       , Hh^Fmw      
Gs^Fp       , Ce          , Ce          , Ce          , Gs^Fp       , Gs^Fp       , Gg^Ve       , Hh^Fmw      , Hh^Fdw      , Hh^Fdw      , Hh^Fdw      , Gs^Fp       , Gs^Fp       , Gs^Fp       , Re          , Ww^Bw/      , Ww          , Ww          , Ww          , Gs^Fp       , Ww          , Gs^Fp       , Ww          , Ww          , Ww          , Ww          , Ww          , Ww          , Gs^Fp       , Gg^Ve       , Hh^Fdf      , Gs^Fp       , Hh^Fmw      , Hh^Fdf      , Hh^Fmw      , Hh^Fmf      , Hh^Fmf      
Hh^Fmf      , Gs^Fp       , Gs^Fp       , Gs^Fp       , Gs^Fp       , Gs^Fp       , Gs^Fp       , Hh^Fdf      , Gs^Fp       , Hh^Fmw      , Hh^Fdf      , Gs^Fp       , Re          , Re          , Gs^Fp       , Gs^Fp       , Gs^Fp       , Ww          , Ww          , Ww          , Ww          , Ww          , Ww          , Ww          , Ww          , Ww          , Gs^Fp       , Gs^Fp       , Hh^Fdf      , Hh^Fdf      , Hh^Fdw      , Hh^Fdf      , Hh^Fdf      , Hh^Fdf      , Hh^Fmf      , Hh^Fmf      , Hh^Fmw      
Gs^Fp       , Gs^Fp       , Re          , Re          , Re          , Re          , Re          , Re          , Re          , Re          , Re          , Re          , Gs^Fp       , Gs^Fp       , Gs^Fp       , Gg^Fet      , Gs^Fp       , Gs^Fp       , Gg^Ve       , Ww          , Gs^Fp       , Ww          , Gs^Fp       , Gs^Fp       , Gg^Ve       , Gs^Fp       , Hh^Fdf      , Hh^Fdf      , Hh^Fdf      , Hh^Fdw      , Mm          , Hh^Fdw      , Hh^Fdf      , Hh^Fmw      , Mm          , Mm          , Mm          
Re          , Re          , Gs^Fp       , Gs^Fp       , Gs^Fp       , Gs^Fp       , Gs^Fp       , Gs^Fp       , Gs^Fp       , Aa^Fpa      , Gs^Fp       , Gs^Fp       , Gs^Fp       , Gs^Fp       , Gs^Fp       , Gs^Fp       , Aa^Fpa      , Gs^Fp       , Gs^Fp       , Gs^Fp       , Gs^Fp       , Gs^Fp       , Gs^Fp       , Gs^Fp       , Hh^Fdw      , Hh^Fmw      , Hh^Fdw      , Hh^Fmw      , Hh^Fdw      , Mm          , Mm          , Mm          , Mm          , Mm          , Mm          , Ha^Fda      , Mm          
Gs^Fp       , Hh^Fmf      , Gs^Fp       , Gs^Fp       , Hh^Fmf      , Gg^Ve       , Gs^Fp       , Gs^Fp       , Gs^Fp       , Gs^Fp       , Aa^Fpa      , Aa^Fpa      , Gs^Fp       , Gs^Fp       , Gs^Fp       , Gs^Fp       , Gs^Fp       , Aa^Fpa      , Gs^Fp       , Aa^Fpa      , Gs^Fp       , Gs^Fp       , Hh^Fdf      , Hh^Fdf      , Hh^Fdw      , Hh^Fmw      , Mm          , Mm          , Mm          , Mm          , Mm          , Mm          , Mm          , Mm          , Mm          , Mm          , Mm          
Gs^Fp       , Gs^Fp       , Gs^Fp       , Hh^Fmf      , Hh^Fp       , Ha^Fpa      , Gs^Fp       , Gs^Fp       , Gs^Fp       , Aa^Fpa      , Gs^Fp       , Gs^Fp       , Gs^Fp       , Gs^Fp       , Gg^Ve       , Gs^Fp       , Gs^Fp       , Gs^Fp       , Gs^Fp       , Gs^Fp       , Hh^Fdw      , Hh^Fmw      , Mm          , Mm          , Mm          , Mm          , Mm          , Mm          , Mm          , Mm          , Mm          , Mm          , Mm          , Mm          , Mm          , Mm          , Mm          
Gs^Fp       , Gs^Fp       , Hh^Fmf      , Hh^Fp       , Hh^Fp       , Hh^Fp       , Gs^Fp       , Gs^Fp       , Cv          , Cv          , Cv          , Gg^Fet      , Gs^Fp       , Gs^Fp       , Gs^Fp       , Gs^Fp       , Hh^Fdw      , Hh^Fdf      , Hh^Fmw      , Gg^Ve       , Hh^Fmf      , Hh^Fdw      , Mm          , Mm          , Mm          , Mm          , Ms          , Ha^Fpa      , Mm          , Mm          , Hh^Fmw      , Mm          , Mm          , Mm          , Hh^Fmf      , Mm          , Mm          
Gs^Fp       , Gg^Ve       , Gs^Fp       , Gs^Fp       , Gs^Fp       , Ha^Fpa      , Gs^Fp       , Gg^Fet      , Cv          , 2 Kv        , Cv          , Gs^Fp       , Gs^Fp       , Gs^Fp       , Hh^Fdf      , Hh^Fdf      , Hh^Fdw      , Hh^Fdw      , Mm          , Hh^Fdf      , Mm          , Mm          , Hh^Fdf      , Mm          , Hh^Fdw      , Mm          , Mm          , Mm          , Mm          , Mm          , Mm          , Mm          , Mm          , Mm          , Hh^Fmw      , Mm          , Mm          
Hh^Fmf      , Gs^Fp       , Gs^Fp       , Gs^Fp       , Gg^Ve       , Gs^Fp       , Gs^Fp       , Gs^Fp       , Gs^Fp       , Cv          , Gs^Fp       , Gs^Fp       , Hh^Fdf      , Hh^Fmw      , Gg^Ve       , Hh^Fmw      , Mm          , Mm          , Mm          , Mm          , Mm          , Mm          , Mm          , Mm          , Mm          , Mm          , Mm          , Ha^Fpa      , Mm          , Mm          , Mm          , Mm          , Mm          , Hh^Fmf      , Mm          , Mm          , Mm          
Gs^Fp       , Hh^Fmf      , Hh^Fmf      , Gs^Fp       , Hh^Fdf      , Gs^Fp       , Hh^Fmw      , Hh^Fdf      , Hh^Fmw      , Gs^Fp       , Hh^Fdw      , Hh^Fmw      , Hh^Fmw      , Hh^Fmw      , Hh^Fdw      , Hh^Fmw      , Mm          , Mm          , Mm          , Mm          , Mm          , Mm          , Mm          , Hh^Fdw      , Mm          , Mm          , Ms          , Mm          , Mm          , Mm          , Ha^Fda      , Mm          , Mm          , Mm          , Mm          , Mm          , Mm          
Hh^Fmw      , Hh^Fdf      , Hh^Fdw      , Hh^Fdw      , Hh^Fmw      , Hh^Fmw      , Hh^Fdf      , Hh^Fmw      , Hh^Fmf      , Hh^Fdw      , Hh^Fmf      , Hh^Fmw      , Mm          , Hh^Fmf      , Mm          , Mm          , Mm          , Mm          , Mm          , Ms          , Mm          , Mm          , Mm          , Mm          , Mm          , Ha^Fpa      , Ms          , Mm          , Mm          , Mm          , Mm          , Mm          , Mm          , Mm          , Hh^Fmf      , Mm          , Mm          
Hh^Fmf      , Hh^Fdw      , Hh^Fmf      , Hh^Fmf      , Mm          , Hh^Fdw      , Mm          , Hh^Fmf      , Mm          , Hh^Fmf      , Mm          , Mm          , Mm          , Mm          , Hh^Fmw      , Mm          , Mm          , Hh^Fdw      , Hh^Fmw      , Hh^Fmw      , Mm          , Mm          , Ms          , Mm          , Hh^Fdf      , Mm          , Mm          , Mm          , Mm          , Mm          , Mm          , Mm          , Mm          , Mm          , Mm          , Hh^Fmw      , Mm          
Mm          , Mm          , Ha^Fpa      , Mm          , Mm          , Mm          , Ha^Fpa      , Mm          , Mm          , Mm          , Ms          , Mm          , Mm          , Hh^Fdf      , Hh^Fdf      , Mm          , Mm          , Mm          , Hh^Fdw      , Mm          , Mm          , Mm          , Mm          , Mm          , Mm          , Mm          , Mm          , Mm          , Mm          , Mm          , Ha^Fda      , Mm          , Mm          , Mm          , Mm          , Mm          , Mm          
Mm          , Mm          , Mm          , Ms          , Mm          , Ms          , Mm          , Mm          , Mm          , Mm          , Mm          , Mm          , Mm          , Mm          , Mm          , Mm          , Mm          , Mm          , Mm          , Mm          , Mm          , Ms          , Ms          , Ms          , Mm          , Mm          , Mm          , Mm          , Mm          , Mm          , Mm          , Mm          , Mm          , Mm          , Mm          , Mm          , Mm          
