border_size=1
usage=map

Mm          , Mm          , Hh^Fmw      , Mm          , Mm          , Mm          , Ms          , Ms          , Mm          , Mm          , Mm          , Mm          , Ms          , Mm          , Mm          , Mm          , Mm          , Mm          , Mm          , Mm          , Mm          , Mm          , Mm          , Mm          
Ms          , Ms          , Mm          , Hh^Fmw      , Hh^Fmw      , Ms          , Ms          , Mm          , Ha          , Ha          , Mm          , Ms          , Ha          , Ms          , Ms          , Mm          , Mm          , Mm          , Mm          , Mm          , Ha          , Mm          , Ha^Vca      , Mm          
Mm          , Mm^Vc       , Mm          , Hh^Fmw      , Mm          , Mm          , Ms          , Ms          , Hh^Fmf      , Ha          , Ce          , Ms          , Ce          , Ms          , Ce          , Hh^Fmw      , Hh^Fmw      , Hh^Fmw      , Mm          , Mm          , Mm          , Ms          , Mm          , Mm          
Ww          , Ww          , Wo          , Mm          , Ms          , Ms          , Ms          , Ms          , Mm^Vc       , Mm          , Mm          , Ce          , 3 Ke        , Ce          , Mm^Vc       , Mm          , Mm          , Hh^Fmw      , Ms          , Ms          , Ha          , Mm          , Ms          , Mm          
Wo          , Wo          , Wo          , Ww          , Mm          , Mm          , Ms          , Mm          , Mm          , Mm          , Ce          , Ce          , Ce          , Ce          , Ce          , Mm          , Mm          , Ms          , Ha          , Ha^Vca      , Ha          , Ms          , Ms          , Mm          
Wo          , Wo          , Wo          , Ww          , Ww          , Ww          , Ww          , Mm          , Ww          , Ww          , Ww          , Mm          , Ms          , Ms          , Ms          , Mm          , Mm          , Mm          , Ms          , Ms          , Ms          , Ms          , Ha          , Ms          
Wo          , Wo          , Ww          , Mm          , Mm          , Mm          , Mm          , Ww          , Ms          , Mm          , Ms          , Ww          , Ww          , Ms          , Mm          , Ms          , Mm          , Ms          , Ms          , Ms          , Ms          , Mm^Vc       , Ms          , Ms          
Mm          , Ww          , Mm          , Ms          , Hh^Fmw      , Ms          , Mm          , Ms          , Ha          , Ha          , Ms          , Mm          , Mm          , Ww          , Ww          , Ms          , Mm          , Mm          , Ms          , Ms          , Ms          , Ms          , Ms          , Ms          
Mm          , Mm          , Ms          , Hh^Fmw      , Ha^Fma      , Mm^Vc       , Ms          , Ms          , Hh          , Ha^Fma      , Ms          , Ms          , Mm          , Mm          , Mm          , Ww          , Ww          , Mm          , Ww          , Mm          , Mm          , Mm          , Mm          , Mm          
Ms          , Mm          , Mm          , Hh^Fmw      , Hh^Fmw      , Ms          , Ms          , Mm          , Hh^Fmf      , Hh          , Ms          , Mm          , Mm          , Mm^Vc       , Mm          , Mm          , Mm          , Ww          , Ms          , Ww          , Ww          , Mm          , Mm          , Mm          
Mm          , Ms          , Mm          , Hh^Fmf      , Hh^Fmw      , Hh^Fmw      , Mm          , Hh          , Hh          , Hh^Fmf      , Ms          , Ms          , Mm          , Hh^Fmw      , Mm          , Ms          , Ms          , Mm          , Ms          , Ms          , Mm          , Ww          , Mm          , Mm          
Mm          , Mm          , Mm          , Mm          , Mm          , Hh^Fmf      , Hh^Fmw      , Mm          , Mm          , Hh          , Hh          , Ms          , Mm^Vc       , Hh^Fmw      , Hh^Fmw      , Mm          , Mm          , Mm          , Mm          , Mm^Vc       , Mm          , Ww          , Mm          , Mm          
Hh^Fmw      , Mm          , Mm          , Mm          , Ms          , Hh^Fmw      , Hh^Fmw      , Mm          , Mm          , Ha^Fma      , Ha^Fma      , Mm          , Mm          , Mm          , Mm          , Ha^Fma      , Ha^Fma      , Ha^Fma      , Mm          , Mm          , Mm          , Ww          , Ww          , Mm          
Mm          , Hh^Fmw      , Mm          , Ms          , Ha^Fma      , Hh^Fmw      , Ms          , Hh^Fmw      , Mm          , Hh^Fmw      , Hh^Fmw      , Ms          , Ms          , Mm          , Mm          , Mm          , Ms          , Ms          , Ms          , Mm          , Mm          , Mm          , Mm          , Ww          
Mm          , Mm          , Ms          , Ms          , Ms          , Hh          , Ha^Fma      , Hh^Vc       , Ms          , Hh          , Ha^Fma      , Ms          , Ms          , Mm          , Mm          , Mm          , Ms          , Mm^Vc       , Ms          , Ms          , Mm          , Mm          , Mm^Vc       , Mm          
Mm          , Mm          , Mm          , Ms          , Ms          , Ms          , Hh^Fmw      , Hh^Fmw      , Hh^Fmw      , Hh^Fmw      , Hh^Fmf      , Hh          , Mm          , Mm          , Mm          , Ms          , Ha          , Ms          , Ms          , Ms          , Ms          , Mm          , Mm          , Mm          
Mm          , Mm^Vc       , Mm          , Mm          , Ms          , Ms          , Ha          , Hh^Fmw      , Ms          , Ha          , Hh^Fmw      , Hh^Fmf      , Mm          , Mm          , Mm          , Ms          , Ms          , Ha^Fma      , Ms          , Ms          , Ms          , Ms          , Ms          , Mm          
Mm          , Mm          , Mm          , Mm          , Ms          , Ha          , Hh^Fmw      , Ms          , Ms          , Ms          , Ms          , Hh^Fmw      , Mm          , Mm^Vc       , Mm          , Ms          , Mm          , Mm          , Mm          , Ms          , Mm          , Ha^Fma      , Mm          , Mm          
Mm          , Hh^Fdw      , Hh^Fdw      , Mm          , Hh          , Hh^Fmf      , Hh^Fmw      , Ms          , Ms          , Mm^Vc       , Ms          , Hh          , Mm          , Mm          , Mm          , Mm          , Ms          , Ms          , Mm          , Mm^Vc       , Hh^Fmw      , Hh^Fmw      , Mm          , Mm          
Mm          , Hh^Fdw      , Mm          , Mm          , Mm          , Mm          , Mm          , Hh^Fmf      , Mm          , Mm          , Hh^Fmf      , Hh          , Mm          , Mm          , Mm          , Hh^Fmf      , Hh^Fmf      , Hh^Fmf      , Ms          , Mm          , Mm          , Hh^Fmw      , Mm          , Mm          
Mm          , Mm          , Mm          , Mm          , Mm^Vc       , Mm          , Mm          , Hh          , Mm          , Hh          , Mm          , Hh^Fdw      , Hh          , Mm          , Hh^Fmw      , Ha          , Hh          , Ha          , Ms          , Mm          , Mm          , Mm          , Mm          , Mm          
Mm          , Mm          , Mm          , Mm          , Mm          , Mm          , Mm          , Hh^Fdw      , Hh^Fmw      , Mm          , Hh^Fmw      , Hh^Fdw      , Mm          , Hh^Vc       , Hh^Fmw      , Ha          , Hh          , Ms          , Mm^Vc       , Mm          , Mm          , Mm          , Mm          , Mm          
Mm          , Ms          , Ms          , Mm          , Mm          , Mm          , Mm^Vc       , Hh^Fmw      , Hh          , Hh^Fmf      , Hh^Fmw      , Hh^Fdw      , Ms          , Mm          , Mm          , Hh          , Hh^Fmw      , Ms          , Mm          , Mm          , Mm          , Hh^Fmw      , Hh^Fmw      , Mm          
Ms          , Ms          , Hh^Fdw      , Hh^Fdw      , Mm          , Mm          , Mm          , Mm          , Hh^Fdw      , Ha^Fma      , Ms          , Ms          , Ms          , Ms          , Hh^Fmw      , Hh^Fmw      , Mm          , Mm          , Mm          , Mm          , Chr         , Chr         , Chr         , Mm          
Mm          , Hh^Fdw      , Ha^Fma      , Ms          , Mm          , Ms          , Ms          , Ms          , Hh^Fdw      , Ha^Fma      , Hh^Fmf      , Hh^Fmf      , Hh^Fmw      , Ms          , Ha^Fma      , Hh^Fmw      , Hh^Fmw      , Mm          , Hh^Fmw      , Mm          , Chr         , 2 Khr       , Chr         , Mm          
Mm          , Ms          , Mm^Vc       , Ms          , Ms          , Ms          , Hh^Fdw      , Hh^Fmw      , Ha^Fma      , Hh          , Mm          , Hh^Fmf      , Mm          , Hh          , Hh          , Hh^Vc       , Hh^Fmw      , Hh^Fmw      , Ms          , Ms          , Ms          , Chr         , Mm          , Mm          
Mm          , Mm          , Mm          , Ms          , Ms          , Ms          , Ce          , Hh^Fdw      , Mm          , Mm          , Mm          , Mm          , Mm          , Hh          , Mm          , Hh^Fmw      , Ha^Fma      , Ha^Fma      , Hh^Fmw      , Ms          , Ms          , Ms          , Mm          , Mm          
Mm          , Hh^Fmw      , Hh^Fmw      , Mm          , Mm          , Ce          , 1 Ke        , Ce          , Mm          , Mm          , Mm^Vc       , Mm          , Mm          , Mm          , Mm          , Hh^Fmw      , Hh^Fmw      , Hh^Fmw      , Ms          , Ms          , Mm          , Mm^Vc       , Mm          , Mm          
Mm          , Hh^Fmw      , Mm          , Ms          , Mm          , Ce          , Ce          , Ce          , Hh^Fdw      , Mm          , Mm          , Mm          , Hh^Fdw      , Mm          , Mm          , Hh^Fdw      , Hh^Fmw      , Hh^Fmw      , Mm          , Mm          , Mm          , Mm          , Mm          , Mm          
Mm          , Mm          , Mm          , Mm          , Mm          , Hh^Fdw      , Hh^Fdw      , Ha^Fma      , Hh          , Hh^Fdw      , Hh          , Hh^Fdw      , Hh          , Mm          , Hh          , Hh^Fmw      , Hh^Fmw      , Hh^Fmw      , Hh^Fmw      , Mm          , Mm          , Mm          , Mm          , Mm          
