border_size=1
usage=map

Gs^Fds      , Gs^Fds      , Gs^Fds      , Gg          , Gg          , Gg          , Gg          , Gg          , Gg          , Gg          , Rr          , Rr          , Rr          , Gg          , Gg          , Gg          , Gs^Fds      , Gs^Fds      , Gs^Fds      , Gg          , Rp^Vhc      , Gg          
Gg          , Gs^Fds      , Gs^Fds      , Gs^Fds      , Gg          , Gg          , Gs^Fds      , Rp^Vhc      , Gg          , Gg          , Rr          , Rr          , Rr          , Gg          , Gg          , Gg          , Gs^Fds      , Gs^Fds      , Gg          , Gs^Fds      , Gg          , Gg          
Gg          , Rp^Vhc      , Gg          , Gg          , Gg          , Gg          , Gg          , Gg          , Gg          , Gg          , Rr          , Rr          , Rr          , Gg          , Gg          , Gg          , Gg          , Gg          , Gg          , Gg          , Gg          , Gg          
Gg          , Gg          , Ch          , Gg          , Gg          , Gg          , Gg          , Gs^Fds      , Gg          , Rp^Vhc      , Rr          , Rr          , Rr          , Gg          , Gg          , Gg          , Gg          , Gg          , Ch          , Ch          , Ch          , Gg          
Gg          , Ch          , 3 Kh        , Ch          , Gg          , Gg          , Gg          , Gg          , Gg          , Gg          , Rr          , Rr          , Rr          , Gg          , Gg          , Rp^Vhc      , Gg          , Gg          , Ch          , 4 Kh        , Ch          , Gg          
Gg          , Ch          , Ch          , Ch          , Gg          , Gg          , Gg          , Gg          , Gg          , Gg          , Rr          , Rr          , Rr          , Gg          , Gg          , Gg          , Gg          , Gg          , Gg          , Ch          , Gg          , Gg          
Gg          , Gg          , Gg          , Gg          , Gg          , Gg          , Rp^Vhc      , Gg          , Gg          , Gg          , Rr          , Rr          , Rr          , Gg          , Gg          , Gg          , Gg          , Gg          , Gs^Fds      , Gg          , Gg          , Gg          
Rp^Vhc      , Gg          , Gg          , Gg          , Gs^Fds      , Gg          , Gg          , Gg          , Wo          , Wo          , Rr          , Rr          , Rr          , Wo          , Wo          , Gg          , Gg          , Gg          , Gs^Fds      , Gs^Fds      , Gg          , Rp^Vhc      
Gg          , Gg          , Gs^Fds      , Gs^Fds      , Gg          , Gg          , Ww          , Ww          , Ch          , Ch          , Rr          , Rr          , Rr          , Ch          , Ch          , Ww          , Ww          , Gg          , Gg          , Gs^Fds      , Gg          , Gg          
Gg          , Gg          , Gg          , Gg          , Ww          , Ww          , Ch          , Ch          , Rr          , Rr          , Rp^Vhc      , Rr          , Rr          , Rr          , Rr          , Ch          , Ch          , Ww          , Ww          , Gg          , Gg          , Gg          
Gg          , Gg          , Wo          , Ww          , Ch          , Ch          , Rp^Vhc      , Rr          , Rr          , Rr          , Rr          , Rr          , Rp^Vhc      , Rr          , Rp^Vhc      , Rr          , Rr          , Ch          , Ch          , Ww          , Wo          , Gg          
Gg          , Gg          , Wo          , Ch          , Rr          , Rr          , Rr          , Rr          , Rr          , Rp^Vhc      , Rr          , Rr          , Rr          , Rr          , Rr          , Rr          , Rr          , Rr          , Rr          , Ch          , Wo          , Gg          
Rr          , Rr          , Rr          , Ch          , Rr          , Rr          , Rp^Vhc      , Rr          , Rr          , Rr          , Ch          , Ch          , Ch          , Rr          , Rr          , Rp^Vhc      , Rr          , Rp^Vhc      , Rr          , Ch          , Rr          , Rr          
Rr          , Rr          , Rr          , Rr          , Rr          , Rr          , Rr          , Rr          , Rr          , Ch          , Ch          , 1 Kh        , Ch          , Ch          , Rr          , Rr          , Rr          , Rr          , Rr          , Rr          , Rr          , Rr          
Rr          , Rr          , Rr          , Rr          , Rr          , Rp^Vhc      , Rr          , Rr          , Rr          , Ch          , Ch          , Ch          , Ch          , Ch          , Rr          , Rr          , Rr          , Rr          , Rp^Vhc      , Rr          , Rr          , Rr          
Rr          , Rr          , Rr          , Rr          , Rr          , Rr          , Rp^Vhc      , Rr          , Rr          , Ch          , Ch          , 2 Kh        , Ch          , Ch          , Rr          , Rp^Vhc      , Rr          , Rr          , Rr          , Rr          , Rr          , Rr          
Gs^Fds      , Rr          , Wo          , Ch          , Rr          , Rr          , Rr          , Rr          , Rr          , Rr          , Rr          , Ch          , Rr          , Rr          , Rr          , Rr          , Rr          , Rp^Vhc      , Rr          , Ch          , Wo          , Rr          
Gg          , Gg          , Wo          , Ch          , Ch          , Rr          , Rr          , Rp^Vhc      , Rr          , Rr          , Rr          , Rr          , Rp^Vhc      , Rr          , Rr          , Rr          , Rr          , Rr          , Ch          , Ch          , Wo          , Gg          
Gg          , Gs^Fds      , Gg          , Ww          , Ww          , Ch          , Ch          , Rr          , Rp^Vhc      , Rr          , Rp^Vhc      , Rr          , Rr          , Rr          , Rp^Vhc      , Rr          , Ch          , Ch          , Ww          , Ww          , Gg          , Gg          
Gg          , Rp^Vhc      , Gg          , Gg          , Gg          , Ww          , Ww          , Ch          , Ch          , Rr          , Rr          , Rr          , Rr          , Rr          , Ch          , Ch          , Ww          , Ww          , Gg          , Gg          , Gg          , Gg          
Gg          , Gg          , Gs^Fds      , Gg          , Gg          , Gg          , Gg          , Ww          , Wo          , Ch          , Rr          , Rr          , Rr          , Ch          , Wo          , Ww          , Gg          , Gg          , Gs^Fds      , Gs^Fds      , Gg          , Rp^Vhc      
Gg          , Gg          , Gs^Fds      , Gg          , Gg          , Gs^Fds      , Gg          , Gg          , Gs^Fds      , Wo          , Rr          , Rr          , Rr          , Wo          , Gg          , Gg          , Gg          , Gg          , Gs^Fds      , Gs^Fds      , Gg          , Gg          
Gg          , Gs^Fds      , Gg          , Gg          , Gg          , Gg          , Gg          , Gg          , Gg          , Gg          , Rr          , Rr          , Rr          , Gg          , Rp^Vhc      , Gg          , Gg          , Gg          , Gg          , Gg          , Gg          , Gg          
Gg          , Gg          , Ch          , Ch          , Ch          , Gg          , Rp^Vhc      , Gg          , Gs^Fds      , Gg          , Rr          , Rr          , Rr          , Gg          , Gg          , Gg          , Gg          , Gg          , Ch          , Ch          , Ch          , Gs^Fds      
Gg          , Gg          , Ch          , 5 Kh        , Ch          , Gg          , Gg          , Gg          , Gg          , Gg          , Rr          , Rr          , Rr          , Gg          , Gs^Fds      , Gs^Fds      , Gg          , Gg          , Ch          , 6 Kh        , Ch          , Gg          
Gg          , Gg          , Gg          , Ch          , Gg          , Gg          , Gg          , Gg          , Gg          , Gg          , Rr          , Rr          , Rr          , Gg          , Gg          , Gs^Fds      , Gg          , Gg          , Gg          , Ch          , Gg          , Gg          
Gg          , Gg          , Gg          , Gg          , Gg          , Gg          , Gg          , Gg          , Gg          , Gs^Fds      , Rr          , Rr          , Rr          , Gg          , Gg          , Gg          , Rp^Vhc      , Gg          , Gg          , Gg          , Gg          , Gg          
Gg          , Gg          , Gg          , Gg          , Gg          , Gg          , Gs^Fds      , Gg          , Gs^Fds      , Gg          , Rr          , Rr          , Rr          , Gg          , Gs^Fds      , Gg          , Gg          , Gg          , Gg          , Gg          , Gg          , Gs^Fds      
Gg          , Gs^Fds      , Gg          , Rp^Vhc      , Gg          , Gg          , Gg          , Gg          , Gg          , Gg          , Rr          , Rr          , Rr          , Gs^Fds      , Gg          , Gg          , Gg          , Gg          , Gg          , Gs^Fds      , Gg          , Gg          
Gg          , Gg          , Gg          , Gg          , Gg          , Gg          , Gg          , Gg          , Gg          , Gg          , Rr          , Rr          , Rr          , Gg          , Rp^Vhc      , Gg          , Gg          , Gs^Fds      , Gg          , Gs^Fds      , Gs^Fds      , Gg          
Gg          , Gg          , Gs^Fds      , Gs^Fds      , Gg          , Gg          , Gg          , Gg          , Gg          , Gg          , Rr          , Rr          , Rr          , Gg          , Gg          , Gg          , Gg          , Gg          , Gg          , Gs^Fds      , Gg          , Gg          
Gg          , Gs^Fds      , Gg          , Gg          , Gg          , Gs^Fds      , Gg          , Gs^Fds      , Gg          , Gg          , Rr          , Rr          , Rr          , Gg          , Gg          , Gs^Fds      , Gg          , Gs^Fds      , Gs^Fds      , Gg          , Gg          , Gg          
