border_size=1
usage=map

Gs^Fp       , Gs^Fp       , Gs^Fp       , Gs^Fp       , Gs^Fp       , Gs^Fp       , Gs^Fdw      , Gg          , Gg          , Gg          , Gg          , Gg          , Gg          , Gg          , Gs^Fp       , Rr          , Re^Vct      , Gg          , Ce          , Rr          , Gg          , Gg          , Gs^Fp       , Gs^Fp       , Gs^Fp       , Gg          , Gg          , Gg          , Gg          , Gg          , Gg          , Gs^Fp       
Gs^Fdw      , Gg^Ve       , Gs^Fp       , Gs^Fdw      , Gs^Fdw      , Gs^Fp       , Gg          , Gg          , Ce          , Ce          , Ce          , Gs^Fp       , Gs^Fdw      , Gg          , Gs^Fdw      , Rr          , Gg          , Ce          , 3 Ke        , Ce          , Gg          , Re^Vct      , Gs^Fdw      , Gs^Fdw      , Gs^Fp       , Gs^Fdw      , Gs^Fp       , Re^Vct      , Ce          , Ce          , Ce          , Gs^Fp       
Gs^Fdw      , Gs^Fdw      , Aa^Fpa      , Aa^Fpa      , Gs^Fdw      , Gs^Fdw      , Re^Vct      , Gg          , Ce          , 4 Ke        , Ce          , Gs^Fp       , Gs^Fdw      , Aa^Fpa      , Aa^Fpa      , Rr          , Gs^Fp       , Ce          , Ce          , Ce          , Gs^Fp       , Gs^Fp       , Gs^Fp       , Aa^Fpa      , Gs^Fdw      , Gs^Fp       , Re^Vct      , Gg          , Ce          , 5 Ke        , Ce          , Gs^Fp       
Gs^Fdw      , Gs^Fp       , Gs^Fp       , Aa^Fpa      , Gg          , Gg          , Gg          , Gs^Fdw      , Gg          , Ce          , Gg          , Re^Vct      , Aa^Fpa      , Aa^Fpa      , Aa^Fpa      , Rr          , Re^Vct      , Gg          , Gg          , Rr          , Gg          , Gs^Fdw      , Gs^Fdw      , Aa^Fpa      , Gs^Fdw      , Gs^Fdw      , Gs^Fp       , Gg          , Gs^Fp       , Ce          , Gg          , Gg          
Gs^Fp       , Gs^Fp       , Gs^Fp       , Gs^Fp       , Gg          , Gs^Fdw      , Gs^Fdw      , Gs^Fdw      , Re^Vct      , Gs^Fp       , Gg          , Gs^Fp       , Gg          , Gs^Fdw      , Gs^Fdw      , Rr          , Gg          , Gs^Fdw      , Ww          , Rr          , Ww          , Re^Vct      , Gs^Fp       , Gs^Fp       , Gs^Fp       , Gs^Fdw      , Gg          , Gg          , Gg          , Gg          , Re^Vct      , Gs^Fp       
Ww          , Ww          , Ss          , Gs^Fp       , Ss          , Gs^Fp       , Ss          , Ww          , Ww          , Ss          , Ss          , Ss          , Ss          , Ww          , Ww          , Ww^Bw|      , Ww          , Ww          , Ww          , Gs^Bw|      , Ww          , Ww          , Ss          , Ss          , Ss^Vm       , Ww          , Ww          , Ss          , Ss          , Ss          , Ww          , Gs^Fp       
Ww          , Ww          , Ww          , Ww          , Ww          , Ss          , Ww          , Ww          , Ww          , Ww          , Ww          , Ss          , Ww          , Ww          , Ww          , Ww^Bw|      , Ww          , Ww          , Ww          , Ww^Bw|      , Ww          , Ww          , Ww          , Ss          , Ww          , Ww          , Ww          , Ww          , Ww          , Ww          , Ww          , Ss          
Wo          , Ww          , Ww          , Ww          , Ww          , Ww          , Ww          , Ww          , Ww          , Ww          , Ww          , Ww          , Ww          , Ww          , Ww          , Ww^Bw|      , Ww          , Ww          , Ww          , Ww^Bw|      , Ww          , Ww          , Ww          , Ww          , Wo          , Wo          , Wo          , Ww          , Wo          , Ww          , Ww          , Ww          
Wo          , Wo          , Wo          , Ww          , Ww          , Ww          , Wo          , Wo          , Wo          , Ww          , Ww          , Ww          , Wo          , Ww          , Ww          , Ww^Bw|      , Ww          , Wo          , Ww          , Ww^Bw|      , Ww          , Ww          , Ww          , Ww          , Ww          , Ww          , Ww          , Wo          , Ww          , Ww          , Ww          , Ww          
Ww          , Wo          , Wo          , Wo          , Ww          , Ww          , Ww          , Wo          , Wo          , Wo          , Wo          , Wo          , Wo          , Wo          , Ww          , Ww^Bw|      , Ww          , Wo          , Ww          , Ww^Bw|      , Ww          , Ww          , Ww          , Ww          , Wo          , Ww          , Ww          , Ww          , Wo          , Wo          , Wo          , Wo          
Ww          , Wo          , Ww          , Ww          , Ww          , Ww          , Ww          , Ww          , Ww          , Wo          , Ww          , Ww          , Ww          , Ww          , Ww          , Ch          , Ww          , Ww          , Ww          , Ch          , Ww          , Ww          , Ww          , Wo          , Wo          , Wo          , Ww          , Wo          , Wo          , Wo          , Wo          , Ww          
Wo          , Ww          , Wo          , Ww          , Wo          , Ww          , Wo          , Ww          , Wo          , Ww          , Ww          , Ww          , Ww          , Ww          , Ww          , Ww^Bw|      , Ww          , Ww          , Ww          , Ww^Bw|      , Ww          , Ww          , Ww          , Wo          , Ww          , Wo          , Wo          , Wo          , Wo          , Wo          , Wo          , Wo          
Wo          , Wo          , Wo          , Wo          , Wo          , Wo          , Wo          , Wo          , Wo          , Ww          , Ch          , Ww          , Ww          , Ww          , Ww          , Ww^Bw|      , Ww          , Ww          , Ww          , Ww^Bw|      , Ww          , Ww          , Ww          , Ww          , Ch          , Ww          , Wo          , Wo          , Wo          , Wo          , Ww          , Wo          
Wo          , Wo          , Ww          , Wo          , Wo          , Ww          , Wo          , Wo          , Ww          , Ww          , Ww          , Ww^Bw\      , Ww^Bw\      , Ww          , Ch          , Ch          , Ch          , Ch          , Ch          , Ch          , Ch          , Ww          , Ww^Bw/      , Ww^Bw/      , Ww          , Ww          , Wo          , Wo          , Wo          , Wo          , Wo          , Wo          
Wo          , Wo          , Wo          , Wo          , Wo          , Wo          , Wo          , Wo          , Wo          , Ww          , Ww          , Ww          , Ww          , Ch          , Rp          , Rp^Vhc      , Rp          , Rp^Vhc      , Rp^Vhc      , Rp          , Rp^Vhc      , Ch          , Ww          , Ww          , Ww          , Ww          , Wo          , Wo          , Wo          , Wo          , Wo          , Wo          
Wo          , Wo          , Wo          , Wo          , Wo          , Ww          , Wo          , Ww          , Wo          , Ww          , Ch          , Ww          , Ww          , Ch          , Rp^Vhc      , Rr          , Ch          , Ch          , Ch          , Rp          , Rp^Vhc      , Ch          , Ww          , Ww          , Ch          , Ww          , Wo          , Wo          , Wo          , Wo          , Wo          , Wo          
Wo          , Wo          , Wo          , Wo          , Ww          , Wo          , Ww          , Wo          , Wo          , Ww          , Ww          , Ww^Bw\      , Ww^Bw\      , Ch          , Rr          , Ch          , Ch          , Rp^Vhc      , Ch          , Ch          , Rp          , Ch          , Ww^Bw/      , Ww^Bw/      , Ww          , Ww          , Wo          , Wo          , Wo          , Wo          , Wo          , Ww          
Wo          , Wo          , Wo          , Wo          , Wo          , Wo          , Wo          , Ww          , Wo          , Wo          , Ww          , Ww          , Ww^Bw/      , Ch          , Rp^Vhc      , 2 Kh        , Ch          , Ch          , Ch          , Kh          , Rp^Vhc      , Ch          , Ww^Bw\      , Ww          , Ww          , Wo          , Wo          , Wo          , Wo          , Ww          , Ww          , Ww          
Wo          , Wo          , Wo          , Wo          , Wo          , Ww          , Wo          , Wo          , Wo          , Ww          , Ch          , Ww^Bw/      , Ww          , Ch          , Rp          , Ch          , Ch          , Rp^Vhc      , Ch          , Ch          , Rp          , Ch          , Ww          , Ww^Bw\      , Ch          , Ww          , Wo          , Wo          , Wo          , Wo          , Wo          , Wo          
Wo          , Wo          , Wo          , Wo          , Ww          , Ww          , Wo          , Wo          , Wo          , Ww          , Ww          , Ww          , Ww          , Ch          , Rp^Vhc      , Rp          , Rp^Vhc      , Ch          , Rp^Vhc      , Rp          , Rp^Vhc      , Ch          , Ww          , Ww          , Ww          , Ww          , Wo          , Wo          , Wo          , Wo          , Ww          , Wo          
Wo          , Wo          , Wo          , Wo          , Wo          , Wo          , Wo          , Wo          , Wo          , Wo          , Ww          , Ww          , Ww^Bw/      , Ch          , Ch          , Rp          , Ch          , Rp          , Ch          , Rp          , Ch          , Ch          , Ww^Bw\      , Ww          , Ww          , Wo          , Wo          , Ww          , Wo          , Ww          , Wo          , Ww          
Wo          , Wo          , Wo          , Wo          , Wo          , Wo          , Wo          , Wo          , Wo          , Ww          , Ch          , Ww^Bw/      , Ww          , Ww          , Ww          , Ch          , Ww          , Ch          , Ww          , Ch          , Ww          , Ww          , Ww          , Ww^Bw\      , Ch          , Ww          , Wo          , Wo          , Wo          , Wo          , Wo          , Wo          
Ww          , Wo          , Ww          , Wo          , Ww          , Wo          , Ww          , Wo          , Ww          , Wo          , Ww          , Ww          , Wo          , Ww          , Ww          , Ww^Bw|      , Ww          , Ww          , Ww          , Ww^Bw|      , Ww          , Ww          , Ww          , Ww          , Ww          , Ww          , Wo          , Wo          , Wo          , Wo          , Wo          , Wo          
Ww          , Ww          , Ww          , Ww          , Ww          , Ww          , Ww          , Wo          , Ww          , Ww          , Ww          , Ww          , Ww          , Ww          , Ww          , Ww^Bw|      , Ww          , Wo          , Ww          , Ww^Bw|      , Ww          , Wo          , Wo          , Ww          , Ww          , Ww          , Wo          , Wo          , Ww          , Ww          , Wo          , Ww          
Wo          , Ww          , Wo          , Wo          , Wo          , Wo          , Wo          , Ww          , Ww          , Ww          , Ww          , Ww          , Wo          , Ww          , Ww          , Ch          , Ww          , Ww          , Ww          , Ch          , Ww          , Ww          , Wo          , Wo          , Wo          , Ww          , Wo          , Wo          , Wo          , Wo          , Wo          , Wo          
Wo          , Ww          , Wo          , Wo          , Wo          , Wo          , Ww          , Wo          , Wo          , Wo          , Wo          , Wo          , Wo          , Wo          , Ww          , Ww^Bw|      , Ww          , Wo          , Ww          , Ww^Bw|      , Ww          , Wo          , Wo          , Wo          , Ww          , Wo          , Wo          , Wo          , Wo          , Wo          , Wo          , Wo          
Ww          , Ww          , Ww          , Wo          , Wo          , Wo          , Wo          , Ww          , Wo          , Wo          , Wo          , Ww          , Wo          , Ww          , Ww          , Ww^Bw|      , Ww          , Wo          , Wo          , Ww^Bw|      , Ww          , Wo          , Wo          , Ww          , Wo          , Wo          , Ww          , Wo          , Ww          , Wo          , Wo          , Wo          
Ww          , Ww          , Ww          , Ww          , Ww          , Ww          , Ww          , Ww          , Ww          , Ww          , Ww          , Ww          , Ww          , Ww          , Ww          , Ww^Bw|      , Ww          , Wo          , Ww          , Ww^Bw|      , Ww          , Ww          , Ww          , Wo          , Ww          , Ww          , Ww          , Ww          , Ww          , Ww          , Ww          , Ww          
Ss          , Ww          , Ww          , Ww          , Ww          , Ww          , Ww          , Ww          , Ww          , Ww          , Ss          , Ww          , Ww          , Ww          , Ww          , Ww^Bw|      , Ww          , Ww          , Ww          , Ww^Bw|      , Ww          , Ww          , Ss          , Ww          , Ww          , Ww          , Ww          , Ww          , Ss          , Ss          , Ss          , Ww          
Hh^Fp       , Ww          , Hh^Fp       , Ss          , Hh^Fp       , Ss          , Hh^Fp       , Ww          , Hh^Fmw      , Ss          , Hh^Fmw      , Ss          , Hh^Fmw      , Ww          , Gs^Fp       , Ww^Bw|      , Gs^Fp       , Ww          , Ww          , Ww^Bw|      , Ww          , Ss          , Hh^Fmw      , Ss          , Hh^Fmw      , Ww          , Hh^Fmw      , Ss          , Hh^Fmw      , Ss          , Hh^Fmw      , Ww          
Hh^Fp       , Hh^Fp       , Hh^Fp       , Ha^Fda      , Hh^Fp       , Hh^Fp       , Hh^Fp       , Hh^Fp       , Hh^Fp       , Hh^Fmw      , Hh^Fmw      , Hh^Fmw      , Hh^Fp       , Hh^Fp       , Gs^Fp       , Rr          , Gs^Fp       , Gs^Fp       , Gs^Fp       , Rp          , Hh^Fmw      , Hh^Fmw      , Gs^Fp       , Gs^Fp       , Hh^Fp       , Hh^Fmw      , Gs^Fp       , Ha^Fpa      , Hh^Fdw      , Hh^Fmw      , Gg^Ve       , Hh^Fmw      
Ha^Fda      , Ha^Fda      , Hh^Fp       , Hh^Fp       , Hh^Fmw      , Hh^Fp       , Hh^Fmw      , Hh^Fmw      , Gs^Fp       , Gs^Fp       , Gs^Fp       , Gs^Fp       , Gs^Fp       , Gs^Fp       , Gs^Fp       , Rr          , Aa^Fpa      , Gs^Fp       , Gg^Ve       , Rp          , Gs^Fp       , Gs^Fp       , Gs^Fp       , Hh^Fmw      , Aa^Fda      , Gg^Ve       , Gs^Fp       , Gs^Fp       , Hh^Fdw      , Ha^Fpa      , Gs^Fp       , Hh^Fmw      
Hh^Fp       , Hh^Fp       , Gg^Ve       , Hh^Fmw      , Hh^Fp       , Ha^Fpa      , Hh^Fmw      , Ha^Fpa      , Hh^Fmw      , Gs^Fp       , Gs^Fp       , Gs^Fp       , Gg^Ve       , Hh^Fp       , Gs^Fp       , Rr          , Gs^Fp       , Gs^Fp       , Gs^Fp       , Rp          , Hh^Fdw      , Hh^Fdw      , Aa^Fda      , Gs^Fp       , Hh^Fdw      , Gs^Fp       , Gs^Fp       , Hh^Fdw      , Gs^Fp       , Hh^Fp       , Gs^Fp       , Hh^Fp       
Aa^Fpa      , Hh^Fp       , Hh^Fp       , Gs^Fp       , Hh^Fp       , Hh^Fmw      , Hh^Fmw      , Hh^Fmw      , Hh^Fmw      , Gs^Fp       , Gs^Fp       , Gs^Fp       , Hh^Fp       , Hh^Fp       , Gs^Fp       , Rr          , Ce          , Ce          , Ce          , Rp          , Hh^Fdw      , Hh^Fp       , Gs^Fp       , Hh^Fdw      , Hh^Fmw      , Ha^Fpa      , Hh^Fmw      , Gs^Fp       , Aa^Fda      , Gs^Fp       , Gs^Fp       , Gs^Fp       
Gs^Fp       , Hh^Fp       , Hh^Fp       , Gs^Fp       , Gs^Fp       , Ha^Fpa      , Hh^Fmw      , Hh^Fmw      , Gs^Fp       , Gg^Ve       , Gs^Fp       , Gs^Fp       , Hh^Fp       , Hh^Fp       , Hh^Fdw      , Rr          , Ce          , 1 Ke        , Ce          , Rp          , Gs^Fp       , Hh^Fdw      , Hh^Fp       , Hh^Fmw      , Gs^Fp       , Ha^Fpa      , Gs^Fp       , Gs^Fp       , Hh^Fp       , Hh^Fp       , Hh^Fp       , Gs^Fp       
Gs^Fp       , Gs^Fp       , Gs^Fp       , Gs^Fp       , Gs^Fp       , Gs^Fp       , Gs^Fp       , Gs^Fp       , Gs^Fp       , Gs^Fp       , Gs^Fp       , Gs^Fp       , Gg^Ve       , Hh^Fp       , Hh^Fdw      , Rr          , Gs^Fp       , Ce          , Gs^Fp       , Rp          , Gs^Fp       , Gs^Fp       , Gs^Fp       , Gs^Fp       , Gs^Fp       , Gs^Fp       , Hh^Fp       , Hh^Fp       , Hh^Fp       , Hh^Fp       , Hh^Fp       , Gs^Fp       
Gs^Fp       , Gs^Fp       , Gs^Fp       , Gs^Fp       , Gs^Fp       , Gs^Fp       , Hh^Fdw      , Gs^Fp       , Gs^Fp       , Gs^Fp       , Gs^Fp       , Gs^Fp       , Gs^Fp       , Gs^Fp       , Hh^Fmf      , Rr          , Gs^Fp       , Gs^Fp       , Hh^Fdw      , Rp          , Gs^Fp       , Gs^Fp       , Gs^Fp       , Gg^Ve       , Hh^Fdw      , Gs^Fp       , Gs^Fp       , Gs^Fp       , Gs^Fp       , Gs^Fp       , Gg^Ve       , Gs^Fp       
Hh^Fdw      , Gs^Fp       , Hh^Fdw      , Gg^Ve       , Hh^Fdw      , Hh^Fdw      , Hh^Fdw      , Hh^Fdw      , Hh^Fdw      , Hh^Fdw      , Hh^Fp       , Hh^Fdw      , Hh^Fdf      , Hh^Fdw      , Hh^Fp       , Rr          , Hh^Fp       , Gg^Ve       , Hh^Fdw      , Rp          , Hh^Fdw      , Hh^Fdw      , Hh^Fdw      , Hh^Fdw      , Hh^Fdw      , Hh^Fdw      , Aa^Fda      , Hh^Fdw      , Aa^Fda      , Hh^Fdw      , Hh^Fp       , Hh^Fp       
Hh^Fdf      , Hh^Fdw      , Hh^Fp       , Hh^Fdw      , Hh^Fp       , Aa^Fda      , Hh^Fdw      , Hh^Fdf      , Hh^Fp       , Hh^Fp       , Aa^Fda      , Hh^Fp       , Hh^Fp       , Hh^Fp       , Hh^Fp       , Rr          , Hh^Fdf      , Hh^Fdf      , Hh^Fdf      , Rp          , Hh^Fdw      , Hh^Fdw      , Hh^Fdf      , Aa^Fda      , Hh^Fdw      , Hh^Fdf      , Hh^Fdf      , Hh^Fdw      , Aa^Fda      , Hh^Fdw      , Aa^Fda      , Hh^Fp       
Aa^Fma      , Hh^Fdf      , Aa^Fma      , Hh^Fdf      , Hh^Fdf      , Hh^Fdf      , Aa^Fda      , Hh^Fp       , Aa^Fda      , Hh^Fdf      , Aa^Fda      , Hh^Fdw      , Hh^Fdw      , Hh^Fdw      , Hh^Fp       , Rr          , Hh^Fdw      , Hh^Fdw      , Hh^Fdf      , Rr          , Hh^Fmw      , Aa^Fda      , Aa^Fda      , Hh^Fdw      , Hh^Fmw      , Aa^Fda      , Hh^Fmw      , Hh^Fdf      , Aa^Fda      , Aa^Fda      , Hh^Fdf      , Hh^Fdf      
Mm          , Aa^Fma      , Hh^Fdf      , Hh^Fp       , Hh          , Ha^Fma      , Aa^Fda      , Hh^Fdf      , Hh          , Hh^Fmw      , Hh^Fmw      , Hh^Fmw      , Ha^Fma      , Ha^Fma      , Hh^Fdw      , Rr          , Hh^Fmw      , Ha^Fma      , Ha^Fma      , Rp          , Hh^Fmw      , Hh^Fmw      , Hh^Fmw      , Hh^Fmw      , Hh^Fdf      , Hh^Fdf      , Hh^Fmw      , Aa^Fda      , Hh^Fmw      , Hh^Fdf      , Mm          , Mm          
Mm          , Mm          , Mm          , Hh^Fp       , Mm          , Mm          , Mm          , Mm          , Mm          , Ha^Fma      , Mm          , Mm          , Mm          , Hh^Fp       , Hh^Fdw      , Rr          , Hh^Fdw      , Mm          , Hh^Fp       , Rp          , Hh^Fp       , Hh^Fmw      , Hh^Fmw      , Hh^Fdf      , Mm          , Mm          , Mm          , Mm          , Mm          , Mm          , Mm          , Mm          
