border_size=1
usage=map

Aa^Fda      , Ha^Fda      , Ha^Vca      , Gg          , Ha^Fda      , Ha^Fma      , Aa^Fpa      , Ha^Fma      , Aa^Fda      , Ha^Fda      , Ha^Fda      , Aa^Fda      , Aa^Fda      , Ms          , Ha^Fpa      , Ms          , Aa^Fpa      , Ms          , Ha^Fda      , Rr          , Aa^Fpa      , Ms          , Aa^Fpa      , Ms          , Aa^Fpa      , Aa^Fpa      , Aa^Fpa      , Aa^Fpa      , Aa^Fpa      , Aa^Fpa      , Aa^Fpa      , Ms          , Aa^Fpa      , Ms          , Ai          , Ww          , Ww          
Gg          , Gg          , Aa^Fpa      , Aa^Fpa      , Gg          , Gg          , Gg          , Gg          , Gg          , Aa^Fpa      , Aa^Fpa      , Ha^Fda      , Gg          , Ha^Fpa      , Gg          , Aa^Fda      , Gg          , Ms          , Ha^Fpa      , Rr          , Aa^Fpa      , Ha^Vca      , Gg          , Aa          , Gg          , Ha^Fda      , Aa^Vca      , Ha^Fda      , Gg          , Aa^Fda      , Ha^Fda      , Ha^Fda      , Ai          , Ai          , Ww          , Ww          , Ww          
Aa^Fda      , Aa^Vha      , Aa          , Aa          , Aa          , Aa^Fpa      , Aa^Fpa      , Aa^Fda      , Gg          , Gg          , Aa^Vca      , Gg          , Aa^Fpa      , Gg          , Aa          , Gg          , Aa          , Gg          , Aa^Fma      , Rr          , Ch          , Aa          , Ch          , Aa^Fpa      , Ch          , Gg          , Ch          , Aa^Fpa      , Ch          , Aa^Fpa      , Ch          , Gg          , Aa^Vca      , Aa          , Ai          , Ai          , Ww          
Gg          , Gg          , Aa^Fpa      , Gg          , Gg          , Gg          , Ch          , Ch          , Ch          , Ch          , Ch          , Ch          , Ch          , Ch          , Ch          , Ch          , Ch          , Ch          , Gg          , Rr          , Aa^Fpa      , Ch          , Aa          , Ch          , Gg          , Ch          , Aa          , Ch          , Aa^Fpa      , Ch          , Gg          , Ch          , Ch          , Aa          , Aa          , Ww          , Ww          
Aa          , Gg          , Aa^Fpa      , Gg          , Ch          , Ch          , Gg          , Aa          , Aa^Fpa      , Gg          , Aa          , Aa          , Aa^Fda      , Gg          , Aa^Fda      , Gg          , Aa^Fpa      , Aa          , Aa^Fpa      , Rr          , Aa^Fpa      , Gg          , Aa^Vha      , Gg          , Aa^Fpa      , Gg          , Aa^Fda      , Gg          , Gg          , Aa^Fpa      , Gg          , Aa^Fpa      , Ai          , Ch          , Aa^Fda      , Ai          , Ai          
Gg          , Aa          , Aa^Fpa      , Aa^Vha      , Ch          , Gg          , Aa          , Aa^Fpa      , Aa^Fpa      , Gg          , Gg          , Gg          , Aa^Fpa      , Gg          , Gg          , Gg          , Aa          , Gg          , Aa^Fpa      , Rr          , Aa          , Gg          , Aa^Fpa      , Gg          , Aa^Fpa      , Aa          , Aa^Fpa      , Aa^Fpa      , Aa^Fpa      , Aa          , Aa^Fpa      , Gg          , Aa^Fpa      , Ch          , Gg          , Aa^Vca      , Aa          
Aa^Fpa      , Gg          , Aa^Fpa      , Gg          , Ch          , Gg          , Aa^Fpa      , Gg          , Ch          , Ch          , Ch          , Ch          , Ch          , Ch          , Ch          , Ch          , Ch          , Ch          , Ch          , Rr          , Ch          , Ch          , Ch          , Ch          , Ch          , Ch          , Ch          , Ch          , Ch          , Ch          , Ch          , Aa^Fpa      , Gg          , Ch          , Gg          , Gg          , Aa          
Gg          , Aa^Fpa      , Gg          , Aa^Fma      , Ch          , Gg          , Aa^Vha      , Aa^Fpa      , Ch          , Rr          , Rr          , Rr          , Rr          , Rr          , Rr          , Rr          , Rr          , Rp^Vhc      , Rr          , Rr          , Rr          , Rr          , Rr          , Rr          , Rr          , Rr          , Rr          , Rr          , Rr          , Rr          , Ch          , Gg^Vh       , Gg          , Ch          , Aa^Fma      , Gg          , Gg          
Aa^Fpa      , Aa^Vha      , Gg          , Gg          , Ch          , Aa          , Aa          , Gg          , Ch          , Rr          , Rr          , Rp^Vhc      , Rr          , Rr          , Rp^Vhc      , Rr          , Rr          , Rr          , Ch          , Ch          , Ch          , Rr          , Rr          , Rp^Vhc      , Rr          , Rr          , Rr          , Rp^Vhc      , Rr          , Rr          , Ch          , Gg          , Aa^Fma      , Ch          , Gg          , Aa^Vla      , Gg          
Aa^Fda      , Aa^Fpa      , Aa^Fpa      , Aa^Fma      , Ch          , Aa^Fpa      , Aa^Fpa      , Gg          , Ch          , Rr          , Rr          , Rr          , Ch          , Rr          , Rr          , Rr          , Ch          , Ch          , Ch          , Rp^Vhc      , Ch          , Ch          , Ch          , Rr          , Rr          , Rr          , Ch          , Rr          , Rr          , Rr          , Ch          , Gg          , Gg          , Ch          , Gg          , Aa^Fma      , Gg          
Rr          , Rr          , Rr          , Rr          , Rr          , Rr          , Rr          , Rr          , Rr          , Rp^Vhc      , Rr          , Ch          , 3 Kh        , Ch          , Rr          , Rr          , Ch          , Rp^Vhc      , Ch          , 2 Kh        , Ch          , Rr          , Ch          , Rr          , Rr          , Ch          , 4 Kh        , Ch          , Rr          , Rp^Vhc      , Rr          , Rr          , Rr          , Rr          , Rr          , Rr          , Rr          
Aa^Fpa      , Rr          , Aa^Fpa      , Rr          , Ch          , Rr          , Gg          , Rr          , Ch          , Rr          , Rr          , Ch          , Ch          , Ch          , Rr          , Rp^Vhc      , Ch          , Rr          , Ch          , Kh          , Ch          , Rp^Vhc      , Ch          , Rr          , Rr          , Ch          , Ch          , Ch          , Rr          , Rr          , Ch          , Rr          , Gg          , Rr          , Aa^Fda      , Rr          , Gg          
Gg          , Gg          , Aa^Fda      , Aa^Fma      , Ch          , Aa^Fma      , Aa^Fma      , Gg          , Ch          , Rr          , Rp^Vhc      , Rr          , Rr          , Rr          , Rr          , Rr          , Rr          , Ch          , Ch          , Rp^Vhc      , Ch          , Ch          , Rp^Vhc      , Rr          , Rr          , Rr          , Rp^Vhc      , Rr          , Rr          , Rr          , Ch          , Aa^Fda      , Aa          , Ch          , Aa          , Aa^Vha      , Aa^Fda      
Aa^Fpa      , Aa          , Aa^Vha      , Gg          , Ch          , Gg          , Gg          , Gg          , Ch          , Rr          , Rr          , Rr          , Rr          , Rp^Vhc      , Rr          , Rr          , Rr          , Rp^Vhc      , Rr          , Ch          , Rr          , Rr          , Rr          , Rr          , Rr          , Rr          , Rr          , Rr          , Rr          , Rp^Vhc      , Ch          , Aa^Fda      , Aa          , Ch          , Aa^Fda      , Gg          , Gg          
Gg          , Gg          , Aa^Fma      , Aa^Fma      , Ch          , Aa^Fma      , Aa^Fpa      , Gg          , Ch          , Rr          , Ch          , Rr          , Ch          , Rr          , Ch          , Rr          , Ch          , Rr          , Ch          , Rr          , Ch          , Rr          , Ch          , Rr          , Ch          , Rr          , Ch          , Rr          , Ch          , Rr          , Ch          , Aa^Fpa      , Aa^Fda      , Ch          , Gg          , Aa^Fpa      , Aa^Fda      
Aa^Fpa      , Gg          , Aa^Fma      , Gg          , Ch          , Aa^Fma      , Gg          , Aa^Fpa      , Gg          , Ch          , Gg          , Ch          , Gg          , Ch          , Gg          , Ch          , Gg          , Ch          , Gg          , Rr          , Aa^Fda      , Ch          , Aa^Fda      , Ch          , Aa^Fda      , Ch          , Aa^Fda      , Ch          , Aa^Fda      , Ch          , Aa^Fda      , Gg          , Aa^Fda      , Ch          , Aa^Fpa      , Gg          , Aa          
Gg          , Gg          , Gg          , Aa^Fma      , Ch          , Gg          , Aa^Fma      , Aa^Vha      , Gg          , Gg          , Aa^Fpa      , Aa^Fpa      , Gg^Vh       , Aa^Fpa      , Aa^Fma      , Aa^Fma      , Gg          , Aa^Fpa      , Gg          , Rr          , Aa^Fpa      , Gg          , Aa^Vha      , Aa          , Aa^Fda      , Aa          , Aa          , Gg          , Aa^Fda      , Gg          , Aa          , Aa^Vha      , Gg          , Ch          , Aa^Fpa      , Gg          , Aa          
Gg          , Gg          , Aa^Fpa      , Aa^Vha      , Gg          , Ch          , Ch          , Aa^Fma      , Ch          , Aa^Fpa      , Ch          , Gg          , Ch          , Aa^Fma      , Ch          , Gg          , Ch          , Aa^Fma      , Ch          , Rr          , Gg          , Aa          , Aa          , Gg          , Aa          , Gg          , Aa          , Aa          , Aa          , Aa          , Gg          , Gg          , Ch          , Ch          , Aa          , Aa^Fda      , Gg          
Gg          , Aa          , Gg          , Gg          , Gg          , Aa^Fma      , Gg          , Ch          , Gg          , Ch          , Gg          , Ch          , Gg          , Ch          , Gg          , Ch          , Aa^Fma      , Ch          , Aa^Fpa      , Rr          , Ch          , Ch          , Ch          , Ch          , Ch          , Ch          , Ch          , Ch          , Ch          , Ch          , Ch          , Ch          , Gg          , Aa^Fda      , Aa          , Aa^Fda      , Aa^Fda      
Gg          , Gg          , Aa^Fpa      , Aa^Vha      , Aa          , Aa^Fma      , Aa          , Aa^Fpa      , Gg          , Aa^Fpa      , Aa^Fpa      , Aa^Vca      , Aa^Fma      , Aa          , Aa^Fma      , Gg          , Aa^Fma      , Aa^Fma      , Aa^Fpa      , Rr          , Aa^Fda      , Gg          , Gg          , Aa^Fpa      , Gg          , Aa^Fpa      , Gg          , Gg          , Aa^Fda      , Aa^Fda      , Aa          , Aa          , Aa^Fda      , Aa^Fpa      , Gg          , Aa^Vca      , Gg          
Gg          , Aa          , Aa^Fpa      , Gg          , Aa^Fpa      , Gg          , Gg          , Aa^Fpa      , Aa^Fma      , Gg          , Gg          , Aa          , Gg          , Aa^Fma      , Gg          , Aa^Fma      , Gg          , Gg          , Gg          , Rr          , Gg          , Gg          , Aa          , Aa^Vca      , Aa^Fpa      , Aa^Fpa      , Gg          , Aa^Vca      , Gg          , Gg          , Aa^Fda      , Gg          , Gg          , Aa^Fpa      , Aa^Fpa      , Aa^Fpa      , Gg          
Aa^Vha      , Gg          , Gg          , Aa          , Gg          , Gg          , Aa^Fpa      , Gg          , Aa^Fma      , Aa^Fma      , Aa^Fma      , Aa          , Gg          , Gg          , Gg          , Gg          , Aa^Vha      , Aa^Fma      , Aa^Fpa      , Rr          , Aa^Fma      , Aa          , Gg          , Gg          , Aa^Fpa      , Gg          , Gg          , Aa^Fpa      , Aa^Fpa      , Aa^Fpa      , Aa          , Aa          , Aa^Fpa      , Aa^Fda      , Gg          , Gg          , Aa          
Aa^Fpa      , Aa^Fpa      , Gg          , Aa^Fma      , Gg          , Aa^Fda      , Gg          , Aa^Fpa      , Gg          , Aa^Vla      , Gg          , Gg          , Aa^Fpa      , Aa^Fpa      , Gg          , Aa^Fpa      , Gg          , Gg          , Aa^Fpa      , Rr          , Gg          , Aa          , Aa^Fpa      , Gg          , Aa^Fpa      , Aa^Fpa      , Gg          , Aa          , Aa^Fpa      , Gg          , Gg          , Aa^Fda      , Aa^Fpa      , Gg          , Aa          , Aa^Fpa      , Aa^Fpa      
Gg          , Gg          , Aa^Fpa      , Gg          , Aa^Fpa      , Gg          , Aa^Fda      , Gg          , Gg          , Aa^Fpa      , Gg          , Aa^Fpa      , Gg          , Gg          , Aa^Fma      , Gg          , Gg          , Aa^Fpa      , Gg          , Rr          , Aa^Fda      , Gg          , Gg          , Gg          , Gg          , Gg          , Aa^Fpa      , Gg          , Aa          , Aa^Fpa      , Aa          , Gg          , Aa^Fda      , Aa^Fda      , Gg          , Gg          , Gg          
Aa^Fpa      , Gg          , Gg          , Gg          , Aa          , Gg          , Aa^Vha      , Gg          , Aa^Fpa      , Gg          , Gg          , Gg          , Aa^Fma      , Aa^Fma      , Gg          , Aa^Fpa      , Gg          , Gg          , Gg          , Rr          , Gg          , Aa^Fda      , Gg          , Aa^Vha      , Gg          , Aa^Fda      , Gg          , Gg          , Aa^Fpa      , Aa          , Gg          , Aa          , Gg          , Aa^Fpa      , Gg          , Aa^Fpa      , Aa^Fpa      
Aa^Fpa      , Gg          , Aa^Fpa      , Aa^Fma      , Gg          , Aa^Fpa      , Gg          , Aa          , Gg          , Aa^Fma      , Aa^Fpa      , Aa^Fpa      , Aa^Fpa      , Aa^Fma      , Gg          , Aa^Fpa      , Gg          , Aa^Fpa      , Gg          , Rr          , Gg          , Gg          , Aa          , Gg          , Aa^Fda      , Gg          , Aa          , Aa^Fpa      , Gg          , Gg          , Aa^Fpa      , Aa^Vca      , Gg          , Aa^Fpa      , Gg          , Gg          , Gg          
Gg          , Aa^Fpa      , Aa          , Gg          , Gg          , Aa          , Aa          , Gg          , Gg          , Gg          , Aa          , Gg          , Aa^Vha      , Gg          , Gg          , Aa^Fpa      , Gg          , Aa^Fpa      , Aa^Vca      , Rr          , Gg          , Aa          , Gg          , Aa^Fda      , Gg          , Aa^Fpa      , Gg          , Aa          , Aa          , Gg          , Aa^Fpa      , Gg          , Aa          , Aa          , Aa^Fpa      , Aa^Fpa      , Gg          
Gg          , Gg          , Aa          , Aa^Vha      , Gg          , Gg          , Gg          , Aa^Fpa      , Aa^Fpa      , Aa^Fda      , Gg          , Aa          , Aa^Fpa      , Aa^Fpa      , Gg          , Gg          , Gg          , Aa          , Gg          , Rr          , Aa^Fpa      , Aa^Fda      , Gg          , Gg          , Aa^Fpa      , Aa^Fpa      , Gg          , Aa          , Gg          , Aa^Fpa      , Gg          , Gg          , Aa^Fpa      , Gg          , Aa          , Gg          , Aa^Fpa      
Gg          , Aa^Fpa      , Ai          , Aa^Fpa      , Ai          , Aa^Fma      , Gg          , Gg          , Gg          , Aa^Fpa      , Gg          , Gg          , Aa^Fpa      , Gg          , Gg          , Aa^Fpa      , Gg          , Aa^Fpa      , Aa^Fpa      , Rr          , Gg          , Aa          , Aa^Fpa      , Aa          , Gg          , Aa          , Gg          , Aa^Fpa      , Gg          , Aa          , Aa^Fpa      , Aa^Fpa      , Aa^Fpa      , Gg          , Aa          , Gg          , Aa          
Ai          , Ai          , Ww          , Ai          , Ww          , Ai          , Aa          , Gg          , Aa^Fpa      , Gg          , Aa^Fpa      , Aa^Fpa      , Aa^Fpa      , Gg          , Aa          , Gg          , Aa^Fpa      , Aa^Fpa      , Gg          , Rr          , Aa^Fpa      , Aa          , Aa^Fpa      , Aa          , Gg          , Aa^Fpa      , Gg          , Aa^Fpa      , Aa^Fpa      , Gg          , Aa^Fpa      , Aa^Fpa      , Gg          , Aa^Fpa      , Gg          , Aa          , Aa^Fpa      
Ww          , Ww          , Ww          , Ww          , Ww          , Ww          , Ai          , Aa^Fda      , Gg          , Aa^Fpa      , Aa^Fpa      , Gg          , Aa^Fpa      , Gg          , Gg          , Aa          , Gg          , Aa^Fpa      , Aa^Fpa      , Rr          , Gg          , Aa^Fpa      , Gg          , Aa^Fpa      , Aa^Fpa      , Aa^Fpa      , Aa^Vca      , Gg          , Aa          , Gg          , Gg          , Aa^Fpa      , Gg          , Aa^Fpa      , Aa^Fpa      , Gg          , Aa^Fpa      
Ww          , Ww          , Ww          , Ww          , Ai          , Ai          , Aa^Fpa      , Gg          , Aa          , Gg          , Aa^Vha      , Gg          , Gg          , Gg          , Aa^Fpa      , Gg          , Aa^Fpa      , Gg          , Aa^Fpa      , Rr          , Aa^Fda      , Aa^Fda      , Gg          , Gg          , Gg          , Gg          , Gg          , Aa^Fpa      , Gg          , Aa          , Aa^Fpa      , Aa^Vla      , Aa^Fpa      , Aa^Fpa      , Aa          , Gg          , Aa^Fpa      
Ai          , Ai          , Aa^Fpa      , Ai          , Gg          , Gg          , Aa^Fpa      , Gg          , Aa          , Aa^Fpa      , Gg          , Gg          , Aa          , Aa^Fpa      , Gg          , Aa^Fpa      , Gg          , Gg          , Aa^Fpa      , Rr          , Gg          , Gg          , Aa          , Aa^Fda      , Aa^Fpa      , Aa^Fpa      , Gg          , Aa^Fpa      , Aa^Fpa      , Gg          , Aa          , Gg          , Aa^Fpa      , Gg          , Gg          , Aa^Fpa      , Aa^Fpa      
Gg          , Aa^Fpa      , Gg          , Aa^Fpa      , Aa^Vha      , Gg          , Aa^Fpa      , Aa          , Gg          , Aa^Fpa      , Gg          , Gg          , Aa^Vha      , Aa^Fpa      , Gg          , Gg          , Aa^Fpa      , Aa^Fpa      , Aa^Fpa      , Rr          , Aa^Fda      , Gg          , Aa          , Gg          , Gg          , Gg          , Aa          , Gg          , Gg          , Gg          , Gg          , Aa^Fpa      , Gg          , Aa          , Ha^Fma      , Aa^Fpa      , Ha^Fma      
Gg          , Aa          , Aa^Fpa      , Gg          , Gg          , Gg          , Aa^Fpa      , Gg          , Aa          , Aa^Fpa      , Gg          , Aa^Fpa      , Aa^Fpa      , Gg          , Aa^Fpa      , Aa          , Aa          , Aa          , Gg          , Rr          , Gg          , Aa^Fda      , Gg          , Aa^Vha      , Aa^Fpa      , Aa          , Gg          , Aa^Fpa      , Gg          , Aa^Fpa      , Aa^Vla      , Aa^Fpa      , Aa^Fpa      , Gg          , Ha^Fma      , Ha^Fma      , Ms          
Gg          , Gg          , Gg          , Aa          , Gg          , Aa^Fpa      , Aa^Fpa      , Gg          , Aa^Vha      , Gg          , Aa          , Gg          , Aa^Fpa      , Gg          , Gg          , Gg          , Aa          , Aa^Vha      , Aa^Fpa      , Rr          , Aa          , Gg          , Aa          , Gg          , Aa^Fpa      , Gg          , Gg          , Aa^Fpa      , Aa^Fda      , Gg          , Aa^Fda      , Gg          , Gg          , Aa^Fpa      , Ha^Fma      , Ha^Fma      , Ms          
Gg          , Aa^Vha      , Aa^Fpa      , Aa^Fpa      , Gg          , Aa^Fpa      , Aa          , Gg          , Aa^Fpa      , Gg          , Gg          , Aa^Fpa      , Gg          , Aa^Fpa      , Aa^Fpa      , Aa^Fpa      , Aa^Fpa      , Gg          , Aa^Fpa      , Rr          , Gg          , Gg          , Gg          , Gg          , Ce          , Aa^Fpa      , Aa^Fpa      , Gg          , Aa^Fpa      , Gg          , Aa^Fda      , Aa^Fda      , Aa^Fpa      , Aa^Fpa      , Ha^Fma      , Ms          , Ms          
Aa^Fpa      , Gg          , Gg          , Aa          , Gg          , Gg          , Gg          , Gg          , Aa^Fpa      , Aa^Fpa      , Aa^Fpa      , Aa^Fpa      , Ce          , Ce          , Ce          , Gg          , Aa^Fpa      , Aa          , Aa          , Rr          , Aa^Vla      , Gg          , Ce          , Ce          , Ce          , Ce          , Ce          , Gg          , Aa^Fda      , Gg          , Gg          , Aa          , Gg          , Ha^Fma      , Ha^Fma      , Ms          , Ms          
Gg          , Gg          , Aa^Fpa      , Aa^Fpa      , Aa^Fpa      , Aa^Fpa      , Aa^Vla      , Aa^Fda      , Gg          , Aa          , Gg          , Ce          , Aa^Fpa      , Ce          , Aa^Fpa      , Ce          , Gg          , Aa^Fpa      , Aa^Fpa      , Rr          , Gg          , Aa^Fda      , Ce          , Gg          , 5 Ke        , Aa^Fda      , Ce          , Aa^Fpa      , Gg          , Aa^Fda      , Aa^Fda      , Aa^Fpa      , Aa^Fpa      , Aa          , Ha^Vhha     , Ms          , Ms          
Aa^Fpa      , Aa          , Gg          , Gg          , Aa          , Aa          , Gg          , Aa^Fpa      , Aa          , Gg          , Aa^Fpa      , Ce          , Aa          , 1 Ke        , Aa^Fda      , Ce          , Aa^Fpa      , Aa          , Gg          , Rr          , Aa^Fda      , Gg          , Ce          , Aa^Fda      , Ce          , Aa          , Ce          , Aa^Fpa      , Aa          , Aa^Vca      , Aa^Fpa      , Gg          , Aa          , Gg          , Ha^Fpa      , Ms          , Ms          
Gg          , Aa^Vha      , Aa          , Aa          , Gg          , Aa^Fpa      , Gg          , Gg          , Aa^Fpa      , Aa^Vha      , Gg          , Ce          , Ce          , Ce          , Ce          , Ce          , Gg          , Aa          , Aa^Fpa      , Rr          , Gg          , Gg          , Aa^Fpa      , Ce          , Ce          , Ce          , Aa^Fda      , Gg          , Aa^Fpa      , Gg          , Gg          , Gg          , Gg          , Ha^Fpa      , Gg          , Ha^Fpa      , Ms          
Gg          , Aa^Fda      , Gg          , Aa^Fpa      , Aa^Fpa      , Gg          , Aa          , Aa^Fpa      , Gg          , Aa^Fpa      , Aa          , Gg          , Aa^Fpa      , Ce          , Gg          , Aa^Fpa      , Gg          , Aa^Fpa      , Aa^Fpa      , Rr          , Aa^Fda      , Aa          , Gg          , Gg          , Gg          , Aa^Fpa      , Gg          , Gg          , Aa^Fda      , Aa^Fpa      , Aa^Vla      , Aa^Fpa      , Aa^Fda      , Aa^Fpa      , Ha^Fma      , Ha^Fpa      , Ha^Fma      
Gg          , Aa          , Gg          , Gg          , Aa^Fpa      , Aa          , Gg          , Aa^Fpa      , Aa^Fda      , Gg          , Gg          , Gg          , Aa^Fpa      , Gg          , Aa^Fpa      , Gg          , Aa^Fpa      , Aa^Vha      , Gg          , Rr          , Gg          , Aa^Fda      , Aa^Fpa      , Aa^Fda      , Aa^Fda      , Aa^Fpa      , Aa^Vca      , Gg          , Gg          , Aa^Fpa      , Gg          , Aa          , Aa^Fpa      , Gg          , Ha^Fpa      , Ha^Fpa      , Aa^Fpa      
Gg          , Gg          , Aa^Vha      , Aa^Fpa      , Aa^Fpa      , Aa          , Aa^Fpa      , Gg          , Aa^Fpa      , Gg          , Gg          , Aa^Fda      , Gg          , Gg          , Gg          , Gg          , Aa^Fpa      , Gg          , Aa^Fpa      , Rr          , Aa^Fpa      , Aa^Fpa      , Aa          , Gg          , Gg          , Aa          , Gg          , Aa^Fpa      , Aa^Fpa      , Aa^Fpa      , Aa          , Gg          , Gg          , Aa^Fpa      , Ha^Vca      , Ha^Fpa      , Ms          
Aa^Fpa      , Gg          , Aa^Fda      , Gg          , Gg          , Gg          , Gg          , Gg          , Gg          , Aa          , Aa          , Aa^Vha      , Gg          , Aa          , Aa^Fda      , Gg          , Aa          , Aa^Fpa      , Aa^Fpa      , Rr          , Aa^Vha      , Gg          , Aa^Fda      , Gg          , Aa^Vca      , Gg          , Aa^Fda      , Gg          , Aa^Fpa      , Gg          , Aa^Fpa      , Aa^Fda      , Aa^Fda      , Aa          , Ha^Fpa      , Ha^Fpa      , Ms          
Aa^Fpa      , Gg          , Gg          , Aa          , Aa^Fpa      , Aa^Fpa      , Aa^Vla      , Aa^Fda      , Gg          , Aa          , Gg          , Gg          , Aa          , Aa          , Gg          , Gg          , Aa^Fpa      , Gg          , Aa^Fpa      , Rr          , Aa^Fda      , Gg          , Aa          , Aa^Fda      , Gg          , Gg          , Gg          , Aa^Fda      , Aa^Fda      , Gg          , Aa^Vla      , Gg          , Aa^Fpa      , Gg          , Gg          , Ha^Fpa      , Ha          
Gg          , Aa^Fpa      , Gg          , Gg          , Aa^Fpa      , Gg          , Gg          , Aa^Fpa      , Aa^Fpa      , Aa^Fpa      , Gg          , Aa^Fda      , Gg          , Aa^Fpa      , Aa^Fpa      , Aa^Fpa      , Gg          , Gg          , Aa^Fpa      , Rr          , Gg          , Aa^Fpa      , Aa          , Aa^Fda      , Aa^Fda      , Aa          , Aa          , Aa          , Gg          , Aa^Fda      , Gg          , Aa^Fpa      , Aa          , Aa^Fpa      , Aa^Fda      , Aa^Vca      , Ha^Fma      
