border_size=1
usage=map

Ha          , Ha          , Ha          , Ha          , Aa^Fpa      , Ha          , Aa^Fda      , Ha          , Ha          , Ha          , Ha          , Ai          , Ha          , Ms          , Ms          , Ms          , Ms          , Ms          , Ms          , Ms          , Ms          , Ms          , Ms          , Ms          , Ms          , Ms          , Ms          
Aa^Fda      , Ha^Voa      , Aa^Fda      , Aa^Fpa      , Aa^Fpa      , Aa^Fpa      , Aa^Fda      , Aa^Fpa      , Aa^Fpa      , Aa^Fpa      , Ww          , Ww          , Aa^Fpa      , Ms          , Ha^Fda      , Ha          , Ha^Fda      , Ha          , Ha          , Ms          , Ha^Fda      , Ha          , Ha          , Ha^Fda      , Ha^Fda      , Ha          , Ha          
Aa^Fpa      , Aa^Fpa      , Aa^Fpa      , Aa^Fpa      , Aa^Fpa      , Aa^Fpa      , Aa^Fpa      , Aa^Fpa      , Aa^Fpa      , Ww          , Aa^Fpa      , Aa^Fpa      , Aa^Fpa      , Ha          , Aa^Fpa      , Aa^Fpa      , Aa          , Ha^Fda      , Aa          , Ha          , Aa          , Aa          , Aa          , Aa          , Rd          , Ha^Fda      , Rd          
Aa          , Aa          , Aa          , Aa          , Aa          , Aa^Fpa      , Aa          , Aa^Fpa      , Aa          , Ww          , Aa^Fpa      , Aa^Fpa      , Aa^Fpa      , Aa          , Aa^Fpa      , Aa^Fpa      , Aa^Fpa      , Aa          , Aa          , Aa^Voa      , Aa          , Aa          , Rd          , Rd          , Ce          , Rd          , Aa          
Co          , Co          , Co          , Aa          , Aa          , Aa          , Aa^Voa      , Aa          , Aa          , Ai          , Aa          , Aa          , Aa          , Aa^Fpa      , Aa          , Aa^Fpa      , Aa          , Aa          , Aa          , Aa          , Rd          , Rd          , Aa          , Ce          , 5 Ke        , Ce          , Aa          
Co          , 4 Ko        , Co          , Aa          , Aa          , Aa          , Aa          , Aa          , Ai          , Ai          , Aa          , Aa          , Aa          , Aa          , Aa          , Aa          , Aa          , Aa          , Aa          , Rd          , Aa^Fpa      , Aa^Fpa      , Aa          , Ce          , Ce          , Ce          , Aa          
Aa          , Co          , Aa          , Aa          , Aa          , Aa          , Aa^Fpa      , Aa          , Ww          , Aa          , Aa          , Aa          , Aa          , Aa          , Aa^Voa      , Aa          , Aa          , Aa          , Aa          , Rd          , Aa^Fpa      , Aa          , Aa^Voa      , Aa          , Aa          , Aa          , Ha^Fpa      
Aa          , Aa          , Aa          , Aa          , Aa          , Aa          , Aa^Fpa      , Aa          , Aa^Fpa      , Ww          , Ai          , Aa          , Aa          , Aa          , Aa          , Aa          , Aa^Fpa      , Aa          , Aa^Fpa      , Rd          , Aa          , Aa          , Aa          , Aa          , Ha^Fpa      , Ha^Fpa      , Ha          
Aa          , Aa          , Aa          , Aa          , Aa          , Aa          , Aa          , Aa          , Aa          , Aa          , Ai          , Aa          , Aa          , Aa          , Aa          , Aa          , Aa          , Aa^Fpa      , Aa          , Rd          , Aa          , Aa          , Ha^Fpa      , Aa          , Ha          , Ha          , Ha^Fpa      
Aa          , Aa^Voa      , Aa          , Aa^Fpa      , Aa^Fpa      , Aa          , Aa          , Aa^Fpa      , Aa^Voa      , Aa          , Ww          , Ww          , Ai          , Aa          , Aa          , Aa          , Aa          , Aa          , Rd          , Rd          , Aa          , Aa          , Ha          , Ha          , Ha^Fda      , Ha          , Ha^Voa      
Rd          , Aa          , Aa^Fpa      , Aa^Fpa      , Aa          , Aa          , Aa^Fpa      , Aa          , Aa          , Ai          , Co          , Co          , 2 Ko        , Ww          , Ww          , Aa          , Rd          , Rd          , Aa          , Aa          , Aa          , Ha          , Ha^Fda      , Ha          , Ha^Fda      , Ha          , Ha^Fda      
Aa          , Rd          , Rd          , Rd          , Rd          , Rd          , Rd          , Rd          , Rd          , Ww          , Co          , Aa^Voa      , Co          , Co          , Co          , Ww^Bw/      , Ww          , Aa          , Aa          , Aa          , Aa          , Aa          , Ha          , Ha          , Aa          , Ha^Fpa      , Ha^Fpa      
Aa          , Aa          , Aa          , Aa          , Aa          , Aa          , Aa          , Aa          , Aa          , Ww^Bw\      , Co          , Co          , Co          , Aa^Voa      , Aa^Voa      , Co          , Ww          , Aa          , Aa          , Aa          , Aa          , Aa          , Aa          , Ha^Fpa      , Aa          , Aa          , Aa          
Aa          , Aa          , Aa          , Aa^Fpa      , Aa^Fpa      , Aa          , Aa^Voa      , Aa          , Aa          , Ww          , Co          , Aa^Voa      , Aa^Voa      , Co          , Co          , Ko          , Ai          , Aa          , Aa          , Aa          , Aa^Voa      , Aa          , Aa          , Aa          , Aa          , Aa          , Aa          
Aa          , Aa^Fpa      , Aa^Fpa      , Aa^Fpa      , Aa          , Aa          , Aa^Fpa      , Aa          , Aa          , Ai          , Ww          , Co          , Co          , Co          , Aa          , Co          , Ww          , Aa          , Aa          , Aa          , Aa          , Aa          , Aa          , Aa          , Aa          , Aa          , Aa          
Aa          , Aa          , Aa          , Aa^Fpa      , Aa          , Aa          , Aa^Fpa      , Aa^Fpa      , Aa          , Aa          , Ai          , Co          , Co          , Co          , Aa          , Aa          , Aa          , Ww          , Aa          , Aa          , Aa          , Aa          , Aa          , Aa          , Aa          , Aa^Fpa      , Aa          
Aa^Fpa      , Aa^Fpa      , Aa^Fpa      , Aa^Fpa      , Aa^Fpa      , Aa^Fpa      , Aa^Fpa      , Aa          , Ww          , Ww^Bw\      , Aa          , Co          , Aa          , Aa          , Aa          , Aa          , Ww          , Ww          , Aa          , Aa          , Aa          , Aa          , Aa^Fpa      , Aa          , Aa^Fpa      , Aa          , Aa          
Aa^Fpa      , Aa^Voa      , Aa^Fpa      , Aa^Fpa      , Aa^Fpa      , Aa^Fpa      , Aa^Fpa      , Aa^Fpa      , Ww          , Aa          , Aa          , Aa          , Aa          , Aa          , Aa          , Aa          , Aa          , Ai          , Ww          , Aa          , Aa          , Aa          , Aa          , Aa^Fpa      , Aa^Fpa      , Aa^Fpa      , Aa          
Aa^Fpa      , Aa^Fpa      , Aa^Fpa      , Aa^Fpa      , Aa^Voa      , Aa^Fpa      , Aa^Fpa      , Ww          , Aa          , Aa          , Aa          , Aa          , Aa^Fpa      , Aa          , Aa^Fpa      , Aa^Voa      , Aa          , Aa          , Aa          , Ai          , Ww          , Aa          , Aa          , Aa^Fpa      , Aa          , Aa          , Aa          
Aa^Fpa      , Aa^Fpa      , Aa^Fpa      , Aa^Fpa      , Aa^Fpa      , Aa^Fpa      , Ai          , Ai          , Aa          , Aa          , Aa          , Aa^Fpa      , Aa          , Aa          , Aa          , Aa          , Aa          , Aa          , Aa          , Aa          , Aa^Voa      , Ww          , Ww          , Aa          , Aa          , Aa^Voa      , Aa          
Aa^Fpa      , Aa^Fpa      , Ce          , Aa^Fpa      , Aa^Fpa      , Aa^Fpa      , Ai          , Aa          , Aa          , Aa          , Aa          , Aa          , Aa          , Aa          , Aa          , Aa          , Aa          , Aa          , Ha^Fda      , Aa          , Aa          , Aa          , Aa          , Ai          , Ww          , Aa          , Aa          
Aa^Fpa      , Ce          , 3 Ke        , Ce          , Aa^Fpa      , Aa^Fpa      , Ww          , Aa          , Aa          , Aa^Voa      , Aa          , Ha^Fpa      , Ha^Fpa      , Ha^Fda      , Ha^Fpa      , Ha^Fda      , Ha^Fda      , Ha^Fda      , Ha^Fda      , Aa          , Ha^Fda      , Aa          , Ce          , Aa          , Ai          , Aa^Fpa      , Aa^Fpa      
Aa^Fpa      , Ce          , Ce          , Ce          , Aa^Fpa      , Aa^Fpa      , Ww          , Aa          , Ha^Fda      , Ha^Fpa      , Ha^Fpa      , Ha^Fpa      , Ha^Fda      , Ha^Fda      , Ha^Fda      , Ha^Fda      , Ms          , Ha^Voa      , Ms          , Ha^Fda      , Ha^Fda      , Ce          , 1 Ke        , Ce          , Ww          , Aa          , Aa          
Aa^Fpa      , Aa^Fpa      , Aa^Fpa      , Aa^Fpa      , Aa^Fpa      , Aa^Fpa      , Ww          , Ha^Fpa      , Ha^Fpa      , Ha^Fpa      , Ha^Fpa      , Ha^Fpa      , Ha^Fda      , Ms          , Ms          , Ms          , Ms          , Ms          , Ms          , Ha^Fda      , Aa^Fpa      , Ce          , Ce          , Ce          , Ww          , Aa^Fpa      , Aa          
Aa^Fpa      , Aa^Fpa      , Aa^Voa      , Aa^Fpa      , Aa^Fpa      , Aa^Fpa      , Ai          , Ha^Fpa      , Ha^Fda      , Ha^Voa      , Ha^Fpa      , Ha^Fpa      , Ha^Fda      , Ha^Fda      , Ms          , Ha^Fda      , Ms          , Ms          , Ms          , Ha^Fda      , Ha^Fda      , Ha^Fda      , Ha^Fda      , Ha          , Ha^Fda      , Ai          , Ww          
Aa^Fpa      , Aa^Fpa      , Aa^Fpa      , Aa^Fpa      , Aa^Fpa      , Aa^Fpa      , Ai          , Ha^Fpa      , Ha^Fpa      , Ha^Fpa      , Ha^Fpa      , Ha^Fda      , Ha^Fda      , Ha^Fda      , Ms          , Ms          , Ms          , Ms          , Ms          , Ha^Fda      , Ha^Fda      , Ha^Fda      , Ha^Fda      , Ha          , Ha          , Ha          , Ha          
