border_size=1
usage=map

Aa^Fpa      , Gg          , Gg          , Gg          , Aa^Fpa      , Gg          , Aa          , Aa          , Gg          , Aa          , Gg          , Gg          , Aa^Fpa      , Aa^Fpa      , Aa^Fpa      , Aa^Fpa      , Aa^Fpa      , Aa^Fpa      , Aa^Fpa      , Ss          , Ss          , Aa^Fpa      
Gg          , Gg          , Aa          , Aa^Fpa      , Gg          , Gg          , Ss          , Gg          , Ce          , Ce          , Ce          , Ss          , Ss          , Gg          , Aa          , Aa^Fpa      , Gg          , Ss          , Ce          , Ce          , Ce          , Gg          
Gg          , Aa          , Aa          , Ss          , Gg          , Aa^Voa      , Aa          , Ss          , Ce          , 3 Ke        , Ce          , Ss          , Ss          , Ss          , Aa          , Aa^Voa      , Ss          , Ss          , Ce          , 4 Ke        , Ce          , Aa          
Aa^Voa      , Aa          , Aa          , Ss          , Ss          , Gg          , Aa          , Ss          , Gg          , Ce          , Ss          , Aa          , Aa          , Gg          , Gg          , Aa          , Aa          , Ss          , Ss          , Ce          , Aa          , Ss          
Gg          , Aa          , Aa          , Gg          , Ss          , Aa          , Aa          , Gg          , Ss          , Ss          , Gg          , Gg          , Aa^Voa      , Gg          , Gg          , Aa          , Gg          , Ss          , Aa^Voa      , Gg          , Ss          , Gg          
Gg          , Ss          , Gg          , Ss          , Gg          , Gg          , Ss          , Aa          , Ss          , Ss          , Ss          , Aa          , Gg          , Aa          , Gg          , Ss          , Gg          , Aa          , Ss          , Ss          , Aa          , Gg          
Ss          , Ss          , Ss          , Ss          , Ss          , Ss^Vm       , Gg          , Ss          , Ss          , Aa          , Aa          , Ss          , Ss          , Gg          , Ss          , Ss          , Ss          , Ss          , Ss^Vhs      , Ss          , Ss          , Aa          
Ww          , Ai          , Ww          , Ww          , Ww          , Ss          , Ww          , Ss          , Ai          , Ss          , Ss          , Gg          , Ss          , Ss^Vhs      , Ai          , Ai          , Ai          , Ss          , Ww          , Ai          , Ai          , Ss          
Ww          , Ww          , Ww          , Ai          , Ai          , Ai          , Ss          , Ww          , Ai          , Ai          , Ai          , Ai          , Ai          , Ai          , Ww          , Ww          , Ww          , Ww          , Ai          , Ww          , Ww          , Ww          
Ai          , Ss          , Ss          , Ww          , Ss          , Ww          , Ww          , Ww          , Ss^Vhs      , Ai          , Ww          , Ww          , Ww          , Ww          , Ww          , Chw         , Chw         , Ww          , Ww          , Ai          , Ww          , Ww          
Ai          , Ww          , Ww          , Ww          , Ai          , Ss          , Ww          , Ss          , Ss          , Ss          , Ai          , Ww          , Ww          , Chw         , 2 Khw       , Chw         , Ai          , Ww          , Ww          , Ai          , Ww          , Ww          
Ww          , Ww          , Ss^Vm       , Ai          , Ww          , Ai          , Ww          , Ww          , Ww          , Ai          , Ss^Vhs      , Ai          , Ai          , Chw         , Chs         , Chw         , Ai          , Ww          , Ai          , Ai          , Ai          , Ww          
Ww          , Ss          , Ww          , Ss          , Gg          , Ss          , Gg          , Ss          , Aa          , Ss          , Ss          , Ai          , Ss          , Ss          , Ss          , Ss          , Ss          , Ai          , Ss          , Ai          , Gg          , Ai          
Ss          , Ss          , Ss          , Ss          , Aa          , Gg          , Aa          , Gg          , Ss          , Aa          , Ss          , Ww          , Ss          , Gg          , Aa          , Aa          , Ss          , Ss          , Ss          , Ss^Vhs      , Aa          , Ss          
Gg          , Ss          , Aa          , Gg          , Ss          , Ss          , Ss          , Ss^Vhs      , Ss          , Aa          , Ss          , Ai^Bw/      , Gg          , Ss          , Ss          , Ss          , Gg          , Gg          , Ss          , Ss          , Ss          , Ss          
Aa          , Aa^Voa      , Gg          , Gg          , Gg          , Aa          , Gg          , Ss          , Ss          , Aa          , Gg          , Ai          , Ss          , Gg          , Aa^Voa      , Gg          , Aa          , Aa          , Ss          , Gg          , Aa          , Ss          
Gg          , Aa          , Aa          , Ss          , Ss          , Aa          , Aa          , Gg          , Aa          , Aa          , Ww          , Ai^Bw/      , Ss          , Gg          , Aa          , Ss          , Ss          , Ss          , Aa          , Ss          , Aa          , Aa          
Gg          , Gg          , Ss          , Gg          , Aa          , Aa          , Ss          , Ss          , Gg          , Aa          , Ww          , Gg          , Aa          , Aa          , Ss          , Ss          , Gg          , Ss          , Aa          , Ss          , Gg          , Gg          
Aa          , Aa          , Gg          , Ss          , Gg          , Aa          , Ss^Vm       , Ss          , Ww          , Ss          , Ai          , Ss          , Ss          , Ss          , Ww          , Ss          , Ai          , Ss          , Ww          , Ss          , Ss^Vm       , Ss          
Gg          , Aa          , Ss          , Aa          , Ss          , Gg          , Ss          , Gg          , Ai          , Ww          , Gg          , Ai^Bw|      , Ww          , Ai^Bw|      , Ss^Vhs      , Ai          , Ss          , Ai          , Gg          , Ww          , Ai          , Ww          
Ss          , Ss^Vm       , Ss          , Gg          , Ai          , Ww          , Ww          , Ai          , Gg          , Ss          , Gg          , Ss          , Gg          , Ss          , Ss          , Ss          , Gg          , Gg          , Gg          , Ss          , Gg          , Aa          
Ww          , Ww          , Ww          , Ai          , Gg          , Ss          , Gg          , Ss          , Gg          , Gg          , Aa^Fma      , Aa^Fma      , Gg          , Gg          , Aa^Fma      , Gg          , Gg          , Aa          , Gg          , Gg          , Aa^Voa      , Gg          
Gg          , Ss          , Ss          , Ss          , Aa          , Gg          , Aa          , Gg          , Aa          , Gg          , Gg          , Gg          , Ce          , Gg          , Gg          , Aa          , Gg^Vo       , Gg          , Aa^Fda      , Aa          , Gg          , Aa          
Gg          , Gg          , Gg          , Gg          , Aa^Fda      , Gg          , Aa          , Gg          , Gg          , Aa          , Gg          , Ce          , 1 Ke        , Ce          , Gg          , Aa          , Gg          , Gg          , Aa^Fda      , Aa          , Gg          , Aa^Fma      
Aa^Fda      , Aa^Fda      , Aa^Fda      , Aa          , Gg          , Aa          , Gg          , Aa^Fma      , Gg          , Aa^Fma      , Gg          , Ce          , Ce          , Ce          , Gg          , Gg          , Aa          , Aa          , Gg          , Aa^Fda      , Gg          , Aa^Fma      
Gg          , Aa^Fda      , Gg          , Gg          , Gg          , Aa^Fda      , Gg          , Aa^Voa      , Aa^Fda      , Aa^Fda      , Gg          , Aa^Fpa      , Aa^Fpa      , Gg          , Aa^Fpa      , Aa^Fpa      , Gg          , Gg          , Aa^Fma      , Aa^Fma      , Aa^Fma      , Aa^Fma      
