border_size=1
usage=map

Hh^Fmw      , Hh^Fmw      , Hh^Fmw      , Hh^Fmw      , Hh^Fmw      , Hh^Fmw      , Hh^Fmw      , Hh^Fdf      , Hh^Fdf      , Hh          , Hh^Fdf      , Ai          , Ww          , Ww          , Ww          , Ai          , Hh^Fdf      , Hh^Fmf      , Hh^Fmw      , Hh^Fmw      , Ms          , Mm          , Mm          , Ms          , Ms^Vhha     , Mm          , Mm          
Ms          , Ms^Vhha     , Ms          , Ms          , Ms          , Mm          , Mm          , Hh^Fmw      , Hh          , Hh          , Ha          , Ai          , Ai          , Ww          , Ww          , Ai          , Aa^Fma      , Aa^Fma      , Aa^Fma      , Aa^Fma      , Ms          , Mm          , Ms          , Ms          , Ms          , Mm          , Mm          
Hh          , Ms          , Aa^Fma      , Mm          , Ce          , Ce          , Ce          , Hh^Fdf      , Ha          , Hh^Fdf      , Aa^Vca      , Ai          , Ai          , Ww          , Ww          , Ai          , Aa^Fma      , Hh^Fmw      , Hh^Fdf      , Ms          , Ce          , Ce          , Ce          , Ms          , Ms          , Mm          , Mm          
Gg          , Aa^Fma      , Gs^Fdw      , Aa^Fma      , Ce          , 2 Ke        , Ce          , Aa^Fma      , Ha          , Hh          , Ha          , Ha          , Ai          , Ww          , Ai          , Ww          , Ha          , Hh          , Hh^Fmw      , Hh^Fdf      , Ce          , 3 Ke        , Ce          , Hh^Fmw      , Ha          , Ms          , Mm          
Gg          , Aa^Fda      , Gg          , Gg          , Gs^Fdw      , Ce          , Ha          , Gg          , Gs^Fdw      , Gg          , Gs^Fdw      , Gg          , Aa^Fma      , Aa          , Gg          , Aa          , Ha          , Gg          , Ha          , Aa^Fma      , Aa^Fma      , Ce          , Aa^Fma      , Hh^Fmw      , Aa^Fma      , Hh^Fmw      , Hh^Fmw      
Gs^Fdw      , Gs^Fdw      , Aa^Vca      , Gs^Fdw      , Aa^Fda      , Gs^Fdw      , Gs^Fdw      , Aa^Fma      , Gs^Fdw      , Aa^Fma      , Gs^Fdw      , Aa^Fma      , Gs^Fdw      , Aa^Fma      , Hh^Fmf      , Gs^Fp       , Aa^Vca      , Gs^Fp       , Gs^Fp       , Hh^Fmf      , Gg          , Hh^Fmf      , Aa^Fda      , Hh^Fmw      , Gg          , Aa^Fma      , Aa^Vca      
Gs^Fdw      , Gs^Fdw      , Gs^Fdw      , Gs^Fdw      , Gs^Fdw      , Gs^Fdw      , Gg          , Gg          , Gg          , Gs^Fdw      , Gg^Ve       , Aa^Fda      , Aa^Fma      , Hh^Fdw      , Hh^Fmf      , Hh          , Gg          , Aa^Fpa      , Gs^Fp       , Gs^Fp       , Hh^Fmf      , Gg          , Aa^Fda      , Gg          , Gg          , Aa^Fma      , Gg          
Gs^Fp       , Gs^Fp       , Aa^Fpa      , Aa^Fda      , Gs^Fdw      , Gg          , Gs^Fdw      , Aa^Fpa      , Gs^Fdw      , Gs^Fdw      , Gs^Fdw      , Gs^Fdw      , Gs^Fdw      , Hh          , Hh^Fmf      , Hh^Fmf      , Aa^Fpa      , Aa^Fpa      , Aa^Fpa      , Gs^Fp       , Hh          , Ha^Fma      , Gg          , Hh^Fmf      , Hh^Fmf      , Aa^Fma      , Gg          
Gg^Ve       , Gs^Fp       , Gs^Fp       , Gs^Fp       , Aa^Fpa      , Gs^Fdw      , Aa^Vca      , Aa^Fma      , Gs^Fdw      , Aa^Fma      , Aa^Fpa      , Aa^Fda      , Gs^Fdw      , Ha          , Hh^Fmf      , Hh          , Gg          , Gg          , Hh          , Hh^Fmw      , Aa^Vca      , Ha^Fma      , Hh^Fmf      , Gg          , Hh^Fmf      , Hh^Fmf      , Gg          
Aa^Fpa      , Gs^Fp       , Aa^Fpa      , Gg          , Gs^Fdw      , Gs^Fdw      , Aa^Fpa      , Gg          , Gg          , Gs^Fdw      , Aa^Fpa      , Gs^Fdw      , Gs^Fdw      , Aa^Fpa      , Aa^Fpa      , Aa^Fpa      , Gs^Fdw      , Aa^Fda      , Gg          , Hh^Fmw      , Gg          , Ha^Fma      , Aa^Fma      , Hh^Fmf      , Aa^Fma      , Aa^Fma      , Gg          
Gs^Fp       , Gs^Fp       , Gs^Fp       , Gs^Fp       , Aa^Fma      , Gg          , Gg          , Aa^Fpa      , Gs^Fdw      , Gs^Fdw      , Gs^Fdw      , Aa^Fda      , Gs^Fdw      , Aa^Fpa      , Ha^Vhha     , Aa^Fpa      , Gs^Fdw      , Aa^Fda      , Aa^Fda      , Gg          , Gg          , Gg          , Gg          , Gg          , Aa^Fma      , Ha^Vhha     , Gg          
Gs^Fp       , Gs^Fp       , Gs^Fdw      , Gs^Fdw      , Gs^Fdw      , Gs^Fdw      , Gs^Fdw      , Gg          , Gs^Fdw      , Gg          , Gg          , Gg          , Gg          , Gs^Fdw      , Aa^Fpa      , Gs^Fdw      , Gg          , Gg          , Hh^Fmf      , Gg          , Gg          , Gg          , Gg          , Gg          , Aa^Fma      , Gg          , Aa          
Gs^Fdw      , Aa^Fma      , Gs^Fdw      , Aa^Vca      , Hh^Fmw      , Hh^Fmw      , Hh^Fmf      , Aa^Fma      , Gs^Fdw      , Aa^Fda      , Gs^Fdw      , Gg          , Aa^Fda      , Gs^Fdw      , Aa^Fpa      , Gg          , Gg          , Gg          , Ha^Fma      , Hh          , Hh^Fmw      , Gg          , Aa^Vca      , Gg          , Ha          , Gg          , Aa          
Gs^Fdw      , Gs^Fdw      , Hh          , Hh^Fmw      , Hh^Fmw      , Hh^Fmf      , Hh^Fmw      , Hh^Fmw      , Gg          , Gg          , Gs^Fp       , Gg          , Aa^Vca      , Gg          , Gg          , Gg          , Hh^Fmf      , Hh^Fmw      , Hh          , Ha^Fma      , Ha^Fpa      , Ha^Fma      , Gg          , Hh^Fmf      , Gg          , Gg          , Ha          
Gs^Fp       , Gg          , Hh^Fmw      , Hh^Fmw      , Ms          , Hh^Fmf      , Hh^Fmw      , Hh^Fmw      , Gs^Fp       , Gg          , Gg          , Gg          , Aa          , Aa          , Hh^Fmf      , Aa          , Aa^Vca      , Gg          , Hh^Fmw      , Ha^Fpa      , Gg          , Gg          , Gg          , Hh^Fmf      , Ha^Fpa      , Ha          , Hh^Fmf      
Hh^Fdw      , Gg          , Ha^Vca      , Hh^Fmw      , Mm          , Ms          , Mm          , Hh^Fmw      , Gg          , Gg          , Gs^Fp       , Gg          , Hh^Fmf      , Hh^Fmw      , Hh^Fmf      , Aa          , Gg          , Gg          , Aa          , Gg          , Gg          , Gg          , Gg          , Hh          , Ha^Fpa      , Hh^Fmf      , Mm          
Gg          , Ha          , Hh          , Hh^Fmw      , Ms          , Ms          , Mm          , Hh^Fmf      , Hh^Fmw      , Gg          , Hh^Fmf      , Hh^Fmf      , Ms          , Hh^Fmf      , Mm          , Hh^Fmw      , Ha^Fpa      , Hh^Fmf      , Gg          , Aa          , Ha^Fpa      , Gg^Vh       , Hh^Fmf      , Hh^Fmf      , Hh^Fmw      , Ms          , Mm          
Ha^Fda      , Gg          , Hh^Fmw      , Hh^Fmf      , Hh^Fmw      , Ms          , Hh^Fmf      , Hh^Fmf      , Hh^Fmw      , Hh^Fmw      , Ha^Vca      , Hh          , Mm          , Ms          , Mm          , Ha^Fpa      , Hh^Fmw      , Hh^Fmf      , Hh^Fmf      , Gg          , Gg          , Ha^Fpa      , Gg          , Ha^Fpa      , Ms          , Ms          , Mm          
Hh^Fmw      , Ha^Fda      , Hh^Fmw      , Hh          , Gg          , Hh^Fmw      , Gg          , Gg          , Gg          , Hh          , Ha^Fda      , Hh^Fmw      , Hh^Fmw      , Ms          , Mm          , Hh^Fmw      , Mm          , Ha^Fpa      , Aa^Fma      , Gg          , Hh^Fmf      , Hh^Fmf      , Gg          , Ha^Fpa      , Hh^Fmw      , Mm          , Mm          
Ha^Fda      , Hh^Fmf      , Ha^Fda      , Hh^Fmw      , Ha^Fda      , Gg          , Gg          , Gg          , Gg          , Hh^Fmw      , Hh^Fmf      , Ha^Fda      , Hh^Fmw      , Ms          , Hh^Fmw      , Hh^Fmw      , Hh^Fmw      , Mm          , Mm          , Aa^Fma      , Gg          , Ha          , Hh^Fmw      , Aa          , Hh^Fmw      , Ms          , Mm          
Ms          , Mm          , Hh^Fmf      , Aa^Vca      , Hh^Fmw      , Gg          , Gg          , Hh^Fmw      , Ha^Fda      , Hh^Fmw      , Hh^Fmf      , Ha^Fda      , Hh^Fmf      , Hh^Fmf      , Mm          , Mm          , Mm          , Ms^Vhha     , Mm          , Aa^Fma      , Ha          , Gg          , Aa          , Gg          , Ha^Fpa      , Ha^Fpa      , Hh^Fmf      
Ms          , Ms          , Hh^Fmf      , Ha^Fda      , Gg          , Gg          , Ha          , Hh          , Gg          , Aa^Vca      , Hh^Fmf      , Ha^Fda      , Hh^Fmf      , Ms          , Mm          , Ha^Fda      , Ha^Fda      , Mm          , Hh^Fmw      , Aa^Fma      , Hh^Fmw      , Aa^Vca      , Gg          , Hh^Fmf      , Mm          , Mm          , Mm          
Mm          , Ms          , Ha^Fda      , Hh^Fmw      , Gg          , Gg          , Ha          , Gg          , Gg          , Gg          , Hh          , Hh^Fmf      , Mm          , Ms          , Hh^Fmw      , Ha^Fda      , Mm          , Ha^Fda      , Gg          , Gg          , Hh^Fmw      , Ha          , Hh^Fmf      , Ha^Fpa      , Mm          , Ms          , Mm          
Hh^Fmw      , Hh^Fmw      , Hh^Fmf      , Hh^Fmw      , Gg          , Hh          , Gg          , Gg          , Gg          , Gg          , Hh          , Ha^Fda      , Hh^Fmw      , Ms          , Mm          , Hh^Fmw      , Mm          , Hh^Fmw      , Ha^Fda      , Hh^Fmw      , Mm          , Hh^Fmf      , Hh          , Mm          , Mm          , Ms^Vhha     , Hh          
Gg          , Ha          , Gg          , Hh^Fmw      , Gg          , Ha          , Gg          , Gg^Vh       , Gg          , Ha          , Ai          , Ai          , Ai          , Ha^Fda      , Ha^Fda      , Ha^Fda      , Mm          , Hh^Fmf      , Gg          , Hh^Fmw      , Ms          , Mm          , Ai          , Ww          , Ms          , Ms          , Mm          
Hh^Fmw      , Gg          , Aa^Vha      , Gg          , Ha          , Gg          , Gg          , Gg          , Gg          , Ai          , Ww          , Ww          , Ww          , Ai          , Mm          , Ha^Fda      , Hh^Fmf      , Ha^Fpa      , Hh^Vhh      , Hh^Fmw      , Ms          , Ms          , Mm          , Hh          , Mm          , Ms          , Mm          
Ha^Fpa      , Gg          , Gg          , Gg          , Gg          , Ha          , Gg          , Gg          , Aa          , Ai          , Ww          , Ww          , Ai          , Ww          , Ms          , Ms          , Mm          , Hh^Fmf      , Hh^Fmf      , Aa^Fma      , Aa^Fma      , Ms          , Hh^Fmw      , Ha^Fpa      , Mm          , Ms          , Mm          
Hh^Fmw      , Hh^Fmw      , Gg          , Ce          , Ce          , Ce          , Gg          , Aa          , Aa          , Ai          , Ww          , Ww          , Ww          , Ai          , Mm          , Mm          , Mm          , Hh^Fmw      , Gg          , Gg          , Hh^Fmf      , Ha^Fpa      , Hh^Fmw      , Hh^Fmw      , Ha^Vca      , Mm          , Hh^Fmw      
Hh          , Ha^Fpa      , Gg          , Ce          , 1 Ke        , Ce          , Gg          , Gg          , Gg          , Gs^Fp       , Ai          , Ai          , Ha^Fpa      , Ai          , Ms          , Ms^Vhha     , Mm          , Hh^Fmw      , Hh^Fmf      , Gg          , Gg          , Ha          , Hh^Fmw      , Aa^Fma      , Hh^Fmw      , Ha^Fpa      , Hh^Fmf      
Hh^Fmw      , Hh^Fmw      , Gg          , Ce          , Ce          , Ce          , Gg          , Gg          , Gs^Fp       , Hh^Fmf      , Ha^Fpa      , Hh^Fmf      , Hh          , Ha^Fda      , Mm          , Ms          , Hh^Fmw      , Hh^Fmf      , Gg          , Gg          , Gg          , Gg          , Hh^Fmf      , Aa^Fma      , Hh^Fmw      , Ha^Fpa      , Mm          
Ha          , Ha^Fpa      , Hh^Fmw      , Ce          , Gg          , Ce          , Gg          , Hh^Fmf      , Hh^Fmw      , Ha^Fpa      , Aa^Vca      , Ha^Fda      , Hh          , Ha^Fda      , Ha          , Ha          , Aa^Fma      , Aa^Fma      , Gg          , Aa^Fma      , Aa^Fma      , Hh^Vhh      , Gg          , Gg          , Mm          , Mm          , Ms^Vhha     
Ha          , Hh^Fmw      , Gg          , Gg          , Gg          , Ha^Fpa      , Ha^Fpa      , Hh^Fmw      , Ha^Fpa      , Hh^Fmw      , Gg          , Hh^Fmw      , Gg          , Hh^Fmw      , Hh^Fmw      , Hh^Fmw      , Hh^Fmf      , Hh^Fmf      , Ha          , Gg          , Gg          , Gg          , Gg          , Ha^Fpa      , Mm          , Mm          , Mm          
