border_size=1
usage=map

Ms          , Ms          , Ms          , Ms          , Ms          , Ms          , Ms          , Ms          , Ms          , Ms          , Ms          , Ms          , Ms          , Ms          , Ms          , Ms          , Ms          , Ms          , Ms          , Ms          , Ms          , Ms          , Ms          , Ms          , Ms          , Ms          , Ms          , Ms          , Ms          , Ms          , Ms          , Ms          , Ms          , Ms          , Ms          , Ms          , Ha          , Ms          , Ms          , Ms          , Ha^Fpa      , Ms          , Ha          , Ms          , Ha^Voa      , Mm          
Ms          , Ms          , Ms          , Ms          , Ms          , Ha^Fpa      , Ms          , Ms          , Ms          , Ms          , Ha^Fpa      , Ms          , Ms          , Ha          , Ha          , Ha          , Ha          , Ms          , Ms          , Ms          , Ha          , Ms          , Ms          , Ms          , Ms          , Ms          , Ha^Fma      , Ms          , Ms          , Ms          , Ms          , Ha^Voa      , Ms          , Ms          , Ms          , Ms          , Ms          , Ms          , Ms          , Ms          , Ms          , Ms          , Ms          , Ms          , Ha          , Ms          
Ms          , Ms          , Ms          , Ha^Fpa      , Ms          , Ms          , Ms          , Ha^Fpa      , Ms          , Ms          , Ms          , Ha          , Ms          , Ms          , Ha^Fda      , Ms          , Ms          , Ha          , Ms          , Ha^Voa      , Ha^Fma      , Ms          , Ms          , Ms          , Ms          , Ms          , Ms          , Ms          , Ms          , Ha^Fpa      , Ms          , Ms          , Ms          , Ms          , Ms          , Ms          , Ha^Fma      , Ms          , Ha^Voa      , Ms          , Ms          , Ms          , Ms          , Ms          , Ha          , Ms          
Ms          , Ha^Fpa      , Ms          , Ms          , Ha^Fpa      , Ha^Fpa      , Ms          , Ms          , Ha^Fpa      , Ms          , Ms          , Ms          , Ha^Fma      , Ha^Fda      , Ms          , Ms          , Ha          , Ms          , Ms          , Ha^Fma      , Ms          , Ha^Fma      , Ha          , Ha^Fma      , Ms          , Ms          , Ms          , Ms          , Ms          , Ms          , Ha^Fpa      , Ms          , Ms          , Ms          , Ha^Fma      , Ms          , Ms          , Ms          , Ms          , Ms          , Ms          , Ms          , Ha^Fpa      , Ms          , Ms          , Ms          
Ms          , Ms          , Ha^Voa      , Ha^Fpa      , Ms          , Ha^Fpa      , Ms          , Ms          , Ms          , Ms          , Ha^Fma      , Ha^Voa      , Ha^Fma      , Ms          , Ms          , Ha^Fda      , Ms          , Ms          , Ms          , Ha          , Ms          , Ms          , Ms          , Ms          , Ms          , Ha^Fma      , Ms          , Ha^Fma      , Ms          , Ms          , Ms          , Ms          , Ms          , Ms          , Ms          , Ms          , Ms          , Ms          , Ha^Fma      , Ms          , Ms          , Ms          , Ms          , Ms          , Ha^Voa      , Ms          
Ms          , Ms          , Ha          , Ms          , Ms          , Ha          , Ms          , Ms          , Ms          , Ms          , Ms          , Ha^Fma      , Ms          , Ha^Fma      , Ms          , Ms          , Ms          , Ha          , Ms          , Ms          , Ms          , Ha^Voa      , Ms          , Ms          , Ms          , Ms          , Ms          , Ha^Fma      , Ha^Fma      , Ms          , Ha          , Ms          , Ms          , Ms          , Ms          , Ms          , Ms          , Ms          , Ms          , Ms          , Ms          , Ha^Fma      , Ms          , Ha^Fma      , Ms          , Ms          
Ms          , Ms          , Ms          , Ha          , Ms          , Ms          , Ha^Fda      , Ms          , Ms          , Ms          , Ha^Fma      , Ms          , Ms          , Ms          , Ms          , Ms          , Ms          , Ms          , Ms          , Ms          , Ms          , Ms          , Ms          , Ms          , Ms          , Ms          , Ha^Fma      , Ms          , Ha          , Ha^Voa      , Ms          , Ms          , Ms          , Ms          , Ha^Fpa      , Ms          , Ms          , Ms          , Ms          , Ms          , Ms          , Ms          , Ha^Fma      , Ms          , Ms          , Ms          
Ms          , Ms          , Ms          , Ms          , Ms          , Ms          , Ms          , Ha^Voa      , Ms          , Ms          , Ms          , Ms          , Ms          , Ms          , Ms          , Ms          , Ms          , Ms          , Ms          , Ms          , Ha          , Ha^Fma      , Ms          , Ms          , Ha^Fma      , Ms          , Ms          , Ms          , Ms          , Ms          , Ms          , Ms          , Ms          , Ms          , Ms          , Ms          , Ms          , Ms          , Ms          , Ha^Voa      , Ms          , Ms          , Ha^Fma      , Ms          , Ha^Fma      , Ms          
Ms          , Ms          , Ms          , Ms          , Ms          , Ms          , Ms          , Ms          , Ha^Fpa      , Ms          , Ha^Fpa      , Ms          , Ms          , Ha^Voa      , Ms          , Ms          , Ms          , Ms          , Ms          , Ha^Voa      , Ha^Fma      , Ms          , Ms          , Ms          , Ms          , Ms          , Ms          , Ms          , Ms          , Ms          , Ms          , Ms          , Ms          , Ha^Fpa      , Ms          , Ms          , Ms          , Ms          , Ms          , Ms          , Ms          , Ms          , Ms          , Ha          , Ms          , Ms          
Ha^Fda      , Ms          , Ms          , Ms          , Ms          , Ms          , Ha^Fda      , Ms          , Ms          , Ha^Fpa      , Ms          , Ms          , Ms          , Ms          , Ms          , Ms          , Ms          , Ms          , Ms          , Ms          , Ms          , Ms          , Ms          , Ms          , Ha^Fma      , Ms          , Ms          , Ms          , Ms          , Ms          , Ms          , Ms          , Ms          , Ms          , Ms          , Ms          , Ha          , Ms          , Ha^Fma      , Ms          , Ha^Fma      , Ms          , Ha^Fma      , Ms          , Ha^Fma      , Ms          
Ha^Fda      , Ha^Fpa      , Ha^Fda      , Ha^Fpa      , Ha^Fda      , Ha          , Ha^Fda      , Ha          , Ha^Fpa      , Ms          , Ha^Fpa      , Ms          , Ha^Fda      , Ha          , Ha^Fda      , Ha^Fda      , Ha^Fda      , Ms          , Ha^Fma      , Ms          , Ha^Fma      , Ha^Fma      , Ha          , Ha          , Aa^Fda      , Ha          , Ha^Fma      , Ms          , Ha          , Ha^Fma      , Ha^Fma      , Ha          , Ha^Fma      , Ha          , Ha          , Ha^Fma      , Ha^Fma      , Ha^Fma      , Ha^Fma      , Ha          , Aa          , Ha          , Aa          , Ha^Fma      , Ha^Fma      , Ha          
Aa          , Aa          , Aa          , Ha^Fpa      , Aa          , Aa          , Aa          , Ha^Fda      , Aa          , Ha^Fda      , Aa          , Aa          , Aa          , Aa          , Aa          , Aa          , Aa          , Aa          , Aa          , Ha^Fma      , Aa          , Ha^Fda      , Aa          , Ha^Fma      , Aa          , Ha          , Co          , Aa          , Co          , Aa          , Aa          , Aa          , Aa          , Aa          , Aa          , Aa          , Aa          , Aa          , Aa          , Aa          , Aa          , Aa          , Aa^Voa      , Aa          , Aa          , Aa          
Aa^Voa      , Aa          , Aa          , Aa          , Aa          , Aa^Voa      , Aa          , Aa          , Aa          , Aa          , Aa          , Aa          , Aa          , Aa^Voa      , Aa          , Aa          , Aa          , Aa          , Co          , Aa          , Aa          , Aa          , Aa          , Aa^Voa      , Aa          , Co          , Co          , Co          , Co          , Co          , Aa          , Aa          , Aa^Voa      , Aa          , Aa          , Aa          , Aa          , Aa^Voa      , Aa          , Aa          , Co          , Aa          , Aa          , Aa          , Aa          , Aa^Voa      
Aa          , Aa          , Aa          , Co          , Aa          , Aa          , Aa          , Co          , Aa          , Aa          , Aa^Voa      , Aa          , Aa          , Aa          , Aa          , Aa          , Aa          , Aa          , Aa          , Aa          , Aa          , Aa          , Aa          , Aa          , Aa          , Aa          , Co          , 3 Ko        , Co          , Aa          , Aa          , Aa          , Aa          , Aa          , Aa          , Aa          , Aa          , Aa          , Aa          , Aa          , Aa          , Aa          , Co          , Aa          , Aa          , Aa          
Aa          , Aa          , Aa          , Aa          , Aa          , Aa          , Aa          , Aa          , Aa          , Aa          , Aa          , Aa          , Aa          , Aa          , Aa          , Aa          , Aa          , Co          , Aa          , Aa          , Aa^Voa      , Aa          , Aa          , Aa          , Aa          , Co          , Co          , Co          , Co          , Co          , Aa          , Aa          , Aa          , Aa          , Aa          , Aa          , Aa          , Aa          , Aa          , Aa          , Aa^Voa      , Aa          , Aa          , Aa          , Aa^Voa      , Aa          
Aa          , Aa^Voa      , Aa          , Aa          , Aa          , Co          , Aa          , Aa          , Aa^Voa      , Aa          , Aa          , Aa          , Co          , Co          , Co          , Aa          , Aa          , Aa          , Aa          , Aa          , Aa          , Aa          , Aa          , Aa^Voa      , Aa          , Aa          , Aa          , Aa          , Aa          , Aa          , Aa          , Aa^Voa      , Aa          , Aa          , Aa          , Co          , Co          , Co          , Co          , Aa          , Aa          , Aa          , Aa          , Aa          , Aa          , Aa          
Aa          , Aa          , Aa          , Aa          , Co          , Aa          , Ai          , Aa          , Aa          , Aa          , Ai          , Aa          , Co          , Co          , Co          , Co          , Ai          , Aa          , Ww          , Aa          , Ai          , Aa          , Ai          , Aa          , Ww          , Aa          , Ai          , Aa          , Ai          , Aa          , Ww          , Aa          , Ww          , Ww          , Ww          , Ai          , Ww          , Co          , Ww          , Ww          , Ai          , Ww          , Ai          , Ww          , Ai          , Ai          
Ww          , Ai          , Ai          , Ai          , Ai          , Ww          , Ai          , Ai          , Ai          , Ai          , Ai          , Ai          , Ww          , Ai          , Ww          , Ww          , Ai          , Ai          , Ai          , Ai          , Ww          , Ai          , Ai          , Ai          , Ai          , Ai          , Ai^Bw|      , Ai          , Ai^Bw|      , Ai          , Ai          , Ai          , Ai          , Ai          , Ai          , Ai          , Ai          , Ai          , Ai          , Ai          , Ai          , Ai          , Ai          , Ai          , Ai          , Ai          
Ai          , Ai          , Ww          , Ww          , Ai          , Ai          , Ww          , Ww          , Ww          , Ww          , Ww          , Ww          , Ww          , Ai          , Ww          , Ai          , Ww          , Ww          , Ww          , Ww          , Ww          , Ai          , Ww          , Ww          , Ww          , Ai          , Ww^Bw|      , Ai^Bw|      , Ww^Bw|      , Ai          , Ww          , Ai          , Ww          , Ai          , Ww          , Ai          , Ww          , Ai          , Ww          , Ai          , Ww          , Ww          , Ww          , Ww          , Ww          , Ww          
Ww          , Ai          , Ww          , Ai          , Ww          , Ww          , Ww          , Ww          , Ww          , Ww          , Ww          , Ww          , Ww          , Ww          , Ww          , Ww          , Ww          , Ww          , Ww          , Ww          , Ww          , Ww          , Ww          , Ww          , Ww          , Ww          , Ww^Bw|      , Ww^Bw|      , Ww^Bw|      , Ww          , Ww          , Ww          , Ww          , Ai          , Ww          , Ww          , Ww          , Ww          , Ww          , Ww          , Ww          , Ww          , Ww          , Ww          , Ww          , Ww          
Ww          , Ww          , Ww          , Ww          , Ww          , Ww          , Wo          , Wo          , Wo          , Wo          , Wo          , Ww          , Wo          , Ww          , Wo          , Ww          , Ww          , Ww          , Ww          , Ww          , Wo          , Ww          , Wo          , Ww          , Ww          , Ww          , Ww^Bw|      , Ww^Bw|      , Ww^Bw|      , Ww          , Ww          , Ww          , Wo          , Ai          , Wo          , Ww          , Wo          , Ww          , Wo          , Ww          , Wo          , Wo          , Wo          , Wo          , Wo          , Ww          
Ai          , Wo          , Wo          , Wo          , Wo          , Wo          , Wo          , Wo          , Wo          , Wo          , Wo          , Wo          , Wo          , Wo          , Wo          , Wo          , Wo          , Wo          , Wo          , Wo          , Wo          , Wo          , Wo          , Wo          , Wo          , Ai          , Ww^Bw|      , Ww^Bw|      , Ww^Bw|      , Wo          , Wo          , Wo          , Wo          , Wo          , Wo          , Wo          , Wo          , Wo          , Wo          , Wo          , Wo          , Wo          , Wo          , Wo          , Wo          , Wo          
Wo          , Wo          , Wo          , Ai          , Wo          , Wo          , Wo          , Ai          , Wo          , Wo          , Wo          , Wo          , Wo          , Wo          , Wo          , Wo          , Ai          , Wo          , Wo          , Wo          , Wo          , Ai          , Wo          , Wo          , Wo          , Wo          , Ch          , Ww^Bw|      , Ch          , Ai          , Wo          , Wo          , Wo          , Wo          , Ai          , Wo          , Wo          , Wo          , Wo          , Wo          , Wo          , Wo          , Ai          , Wo          , Wo          , Wo          
Wo          , Wo          , Ai          , Ai          , Wo          , Wo          , Wo          , Wo          , Wo          , Wo          , Ai          , Ai          , Ai          , Wo          , Wo          , Wo          , Ai          , Wo          , Wo          , Ai          , Wo          , Wo          , Wo          , Wo          , Ai          , Wo          , Ch          , Ch          , Ch          , Wo          , Wo          , Wo          , Ai          , Wo          , Wo          , Wo          , Wo          , Wo          , Wo          , Ai          , Wo          , Wo          , Wo          , Wo          , Ai          , Wo          
Ai          , Wo          , Wo          , Wo          , Wo          , Wo          , Wo          , Wo          , Wo          , Wo          , Wo          , Wo          , Wo          , Wo          , Wo          , Wo          , Wo          , Wo          , Wo          , Wo          , Wo          , Wo          , Wo          , Wo          , Wo          , Wo          , Ww^Bw|      , Ch          , Ww^Bw|      , Wo          , Wo          , Wo          , Wo          , Wo          , Wo          , Wo          , Wo          , Wo          , Wo          , Wo          , Wo          , Ai          , Wo          , Wo          , Wo          , Wo          
Wo          , Wo          , Wo          , Wo          , Wo          , Wo          , Wo          , Wo          , Wo          , Wo          , Wo          , Wo          , Wo          , Wo          , Wo          , Wo          , Wo          , Wo          , Wo          , Wo          , Wo          , Wo          , Wo          , Wo          , Ai          , Ww          , Wo^Bw|      , Ww^Bw|      , Ww^Bw|      , Ww          , Ai          , Wo          , Ww          , Ww          , Ww          , Wo          , Ww          , Wo          , Ww          , Wo          , Ww          , Wo          , Wo          , Wo          , Ww          , Ww          
Ww          , Wo          , Ww          , Wo          , Ww          , Ww          , Ww          , Wo          , Ww          , Ww          , Ww          , Wo          , Ww          , Wo          , Ww          , Wo          , Ww          , Ai          , Ai          , Ai          , Ww          , Ww          , Ww          , Ww          , Ww          , Ai          , Ww^Bw|      , Ww^Bw|      , Ww^Bw|      , Ww          , Ww          , Ww          , Ai          , Ai          , Ww          , Ai          , Ww          , Ww          , Ai          , Ww          , Ai          , Ww          , Ww          , Ai          , Ai          , Ww          
Ai          , Ai          , Ww          , Ww          , Ww          , Ww          , Ai          , Ai          , Ai          , Ww          , Ww          , Ww          , Ww          , Ww          , Ai          , Ai          , Ai          , Ww          , Ww          , Ai          , Ai          , Ai          , Ai          , Ai          , Ww          , Ai          , Ww^Bw|      , Ww^Bw|      , Ww^Bw|      , Ai          , Ww          , Ai          , Ai          , Ww          , Ai          , Ww          , Ai          , Ai          , Ww          , Ai          , Ww          , Ai          , Ww          , Ww          , Ai          , Ai          
Ww          , Ww          , Ai          , Ai          , Ai          , Ww          , Ww          , Ww          , Ai          , Ai          , Ww          , Ww          , Ww          , Ai          , Ww          , Ww          , Ww          , Ai          , Ww          , Ww          , Ww          , Ww          , Ww          , Ww          , Ww          , Ww          , Ww^Bw|      , Ww^Bw|      , Ww^Bw|      , Ww          , Ww          , Ai          , Ww          , Ww          , Ai          , Ww          , Ww          , Ww          , Ai          , Ai          , Ww          , Ai          , Ai          , Ww          , Ai          , Ww          
Ww          , Ww          , Ww          , Ww          , Ww          , Ai          , Ai          , Ww          , Ai          , Ai          , Ww          , Ww          , Ai          , Ai          , Ww          , Ww          , Ai          , Ww          , Ww          , Ww          , Ww          , Ww          , Ww          , Ww          , Ai          , Ww          , Ai^Bw|      , Ai^Bw|      , Ai^Bw|      , Ww          , Ai          , Ww          , Ww          , Ww          , Ww          , Ai          , Ai          , Ai          , Ai          , Ww          , Ai          , Ai          , Ww          , Ai          , Ai          , Ai          
Ai          , Ai          , Ai          , Ww          , Ai          , Ai          , Ww          , Ai          , Ai          , Ai          , Ai          , Ai          , Ww          , Ai          , Ai          , Ai          , Ww          , Ai          , Ai          , Ai          , Ai          , Ai          , Ai          , Ai          , Ai          , Ai          , Ai^Bw|      , Ai^Bw|      , Ai^Bw|      , Ai          , Ww          , Ai          , Ai          , Ai          , Ai          , Ai          , Ww          , Ww          , Ai          , Ai          , Ww          , Ai          , Ww          , Ai          , Ww          , Ai          
Ai          , Ai          , Ai          , Ai          , Ww          , Ai          , Ai          , Ai          , Ai          , Ww          , Ww          , Ai          , Ai          , Ai          , Ww          , Ai          , Ai          , Ai          , Aa          , Ai          , Aa          , Aa          , Aa          , Ai          , Aa          , Ch          , 4 Kh        , Rd          , 5 Kh        , Ch          , Aa          , Ai          , Aa          , Ww          , Aa          , Aa          , Aa          , Aa          , Aa          , Aa          , Aa^Voa      , Aa          , Aa^Fpa      , Aa          , Aa          , Aa          
Aa          , Aa          , Aa          , Ai          , Aa          , Ai          , Aa          , Aa          , Aa          , Aa          , Aa          , Aa          , Aa          , Aa          , Aa          , Aa          , Aa          , Aa          , Aa^Voa      , Aa          , Aa^Fpa      , Aa          , Aa^Fpa      , Aa          , Aa          , Ch          , Rd          , Rd          , Rd          , Ch          , Aa          , Aa          , Aa          , Aa          , Aa^Fpa      , Aa^Fpa      , Aa          , Aa          , Aa          , Aa          , Aa          , Aa          , Aa          , Aa^Fpa      , Aa          , Aa^Voa      
Ha^Fda      , Ha^Fda      , Aa          , Aa          , Aa^Voa      , Aa          , Aa          , Aa          , Aa          , Aa          , Aa          , Aa^Voa      , Aa          , Aa          , Aa^Fpa      , Aa          , Aa          , Aa          , Aa          , Aa          , Aa          , Aa^Fpa      , Aa          , Aa          , Aa          , Aa          , Rd          , Rd          , Rd          , Aa          , Aa          , Aa^Voa      , Aa          , Aa          , Aa^Fpa      , Aa^Fpa      , Aa          , Aa^Fpa      , Aa          , Aa          , Aa          , Aa          , Aa          , Aa          , Aa^Fpa      , Aa          
Ms          , Ha^Fda      , Ha^Fda      , Aa          , Aa          , Aa          , Aa          , Aa          , Aa^Fpa      , Aa          , Aa^Fpa      , Aa          , Aa          , Aa^Fpa      , Aa          , Aa^Fpa      , Aa          , Aa          , Aa          , Aa          , Aa          , Aa          , Aa          , Aa          , Aa          , Aa          , Rd          , Rd          , Rd          , Aa          , Aa^Fpa      , Aa          , Aa          , Aa          , Aa          , Aa          , Aa          , Aa          , Aa          , Aa          , Aa^Fpa      , Aa          , Aa          , Aa          , Aa^Fpa      , Aa^Fpa      
Ms          , Ms          , Ha^Fda      , Ha^Fda      , Aa          , Aa          , Aa          , Aa^Fpa      , Aa^Fpa      , Aa          , Aa          , Aa          , Aa          , Aa^Fpa      , Aa^Fpa      , Aa^Fpa      , Aa          , Aa          , Aa          , Aa          , Aa^Fpa      , Aa^Fpa      , Aa^Fpa      , Aa          , Aa          , Aa          , Rd          , Rd          , Rd          , Aa          , Aa          , Aa          , Aa          , Aa          , Aa          , Aa^Voa      , Aa          , Aa          , Aa^Fpa      , Aa          , Aa          , Aa^Fpa      , Aa          , Aa          , Aa          , Aa^Fpa      
Ms          , Ha^Fda      , Ms          , Ha^Fda      , Ha^Fda      , Aa          , Aa          , Aa          , Aa^Fpa      , Aa^Fpa      , Aa^Fpa      , Aa^Fpa      , Aa          , Aa          , Aa^Fpa      , Aa^Fpa      , Aa          , Aa^Voa      , Aa          , Aa          , Aa^Fpa      , Aa          , Aa          , Aa          , Aa^Voa      , Aa          , Rd          , Rd          , Rd          , Aa          , Aa          , Aa          , Aa^Fpa      , Aa          , Aa          , Aa          , Aa          , Aa          , Aa          , Aa^Fpa      , Aa          , Aa^Fpa      , Aa          , Aa          , Aa          , Aa          
Ms          , Ms          , Ha^Fda      , Ha^Fda      , Ha^Fda      , Aa          , Aa          , Aa^Voa      , Aa          , Aa^Fpa      , Aa          , Aa          , Aa          , Aa          , Aa          , Aa          , Aa          , Aa          , Aa          , Aa          , Aa          , Aa          , Aa          , Aa          , Aa          , Aa          , Rd          , Rd          , Rd          , Aa          , Aa          , Aa          , Aa          , Aa^Fpa      , Aa          , Aa          , Aa          , Aa          , Aa          , Aa          , Aa^Fpa      , Aa          , Aa          , Aa          , Aa^Fpa      , Aa          
Ms          , Ms          , Ha^Fda      , Ha^Voa      , Ha^Fda      , Aa          , Aa          , Aa          , Aa          , Aa          , Aa^Fpa      , Aa          , Aa          , Aa          , Aa          , Aa          , Aa          , Aa          , Aa          , Aa          , Aa          , Aa          , Aa          , Aa          , Aa          , Aa          , Rd          , Rd          , Rd          , Aa          , Aa          , Aa          , Aa^Fpa      , Aa          , Aa          , Aa          , Aa          , Aa^Fpa      , Aa^Fpa      , Aa^Fpa      , Aa          , Aa          , Aa          , Aa          , Aa          , Aa          
Ms          , Ha^Fda      , Ha^Fda      , Ha^Fda      , Ha^Fda      , Aa          , Aa          , Aa          , Aa          , Aa          , Aa^Fpa      , Aa^Fpa      , Aa          , Aa^Voa      , Aa          , Aa          , Aa^Fpa      , Aa^Fpa      , Aa          , Aa          , Aa          , Aa          , Aa          , Aa          , Ce          , Aa          , Ce          , Rd          , Ce          , Aa          , Ce          , Aa          , Aa          , Aa          , Aa^Voa      , Aa          , Aa          , Aa          , Aa          , Aa          , Aa          , Aa^Voa      , Aa          , Aa          , Aa          , Aa          
Ha^Fda      , Ha^Fda      , Ha^Fda      , Ha^Fda      , Aa          , Aa          , Aa          , Aa          , Aa          , Aa^Fpa      , Aa          , Aa          , Aa          , Aa          , Aa          , Aa^Fpa      , Aa^Fpa      , Aa          , Aa          , Aa          , Aa          , Aa          , Aa^Fpa      , Aa          , Aa          , Aa          , Rd          , Rd          , Rd          , Aa          , Aa          , Aa          , Aa          , Aa          , Aa          , Aa          , Aa          , Aa          , Aa          , Aa^Fpa      , Aa^Fpa      , Aa          , Aa^Fpa      , Aa          , Aa          , Aa          
Ha^Fda      , Ha^Fda      , Aa          , Aa          , Aa          , Aa          , Aa          , Aa^Voa      , Aa          , Aa          , Aa          , Aa          , Aa          , Aa          , Aa          , Aa          , Aa          , Aa          , Aa^Voa      , Aa          , Aa          , Aa^Fpa      , Aa^Fpa      , Aa          , Ce          , Ce          , Ce          , Rd          , Rd          , Aa          , Ce          , Ce          , Ce          , Aa          , Aa          , Aa          , Aa          , Aa          , Aa^Fpa      , Aa          , Aa^Fpa      , Aa          , Aa          , Aa          , Aa^Voa      , Aa          
Aa          , Ha^Fda      , Aa          , Aa          , Aa          , Aa          , Aa          , Aa          , Aa          , Aa          , Aa          , Aa          , Aa          , Aa          , Aa          , Aa          , Aa          , Aa          , Aa          , Aa          , Aa          , Aa^Fpa      , Re^Vct      , Aa^Fpa      , Ce          , 1 Ke        , Ce          , Rd          , Rd          , Aa          , Ce          , 2 Ke        , Ce          , Aa          , Aa          , Aa          , Aa          , Aa          , Aa          , Aa          , Aa          , Aa          , Aa          , Aa          , Aa          , Aa          
Aa          , Aa          , Aa          , Aa^Voa      , Aa          , Aa          , Aa^Fpa      , Aa          , Aa          , Aa          , Aa^Fpa      , Aa^Fpa      , Aa          , Aa          , Aa^Fpa      , Aa^Fpa      , Aa^Fpa      , Aa^Fpa      , Aa          , Aa          , Aa          , Aa          , Aa          , Aa          , Aa          , Ce          , Rd          , Rd          , Rd          , Aa          , Aa          , Ce          , Aa          , Aa          , Aa^Fpa      , Aa^Fpa      , Aa^Fpa      , Aa          , Aa          , Aa          , Aa          , Aa          , Aa          , Aa          , Aa^Fpa      , Aa          
Aa          , Aa          , Aa          , Aa          , Aa          , Aa          , Aa          , Aa^Fpa      , Aa          , Aa          , Aa          , Aa^Fpa      , Aa          , Aa          , Aa          , Aa^Fpa      , Aa          , Aa          , Aa          , Aa          , Aa          , Aa          , Aa          , Re^Vct      , Aa          , Aa          , Rd          , Re^Vct      , Rd          , Aa          , Aa^Fpa      , Aa          , Aa          , Aa^Voa      , Aa          , Aa^Fpa      , Aa          , Aa          , Aa          , Aa          , Aa^Fpa      , Aa^Fpa      , Aa^Voa      , Aa          , Aa^Fpa      , Aa^Fpa      
Aa          , Aa          , Aa          , Aa          , Aa          , Aa^Fpa      , Aa^Fpa      , Aa^Fpa      , Aa          , Aa          , Aa          , Aa          , Aa          , Aa^Voa      , Aa          , Aa          , Aa          , Aa          , Aa          , Aa          , Aa          , Aa          , Aa          , Aa          , Aa          , Aa^Fpa      , Rd          , Rd          , Rd          , Aa          , Aa          , Aa          , Aa          , Aa          , Aa          , Aa          , Aa          , Aa          , Aa          , Aa          , Aa          , Aa          , Aa          , Aa          , Aa          , Aa^Fpa      
