border_size=1
usage=map

Aa          , Re          , Re          , Aa          , Aa          , Aa          , Aa          , Aa          , Aa^Voa      , Aa          , Aa^Fpa      , Aa^Fpa      , Aa^Fda      , Aa^Fpa      , Aa^Fda      , Aa^Fpa      , Aa^Fpa      , Aa^Fpa      , Aa^Fpa      , Aa^Voa      , Aa^Fpa      , Aa^Fpa      , Aa^Fpa      , Aa^Fpa      , Aa^Fpa      , Aa^Fpa      
Aa          , Aa          , Aa          , Re          , Re          , Aa          , Aa^Fpa      , Aa^Fpa      , Aa^Fpa      , Aa^Fpa      , Aa^Fpa      , Aa^Fpa      , Aa^Fpa      , Aa^Fpa      , Aa^Fpa      , Aa^Fpa      , Aa^Fpa      , Aa^Fpa      , Aa^Fpa      , Aa          , Aa^Fpa      , Aa^Fpa      , Aa^Fpa      , Aa^Fpa      , Aa^Fpa      , Aa^Fpa      
Aa^Voa      , Aa^Fpa      , Aa^Fpa      , Aa^Fpa      , Aa          , Re          , Re          , Aa^Fda      , Aa^Fpa      , Aa^Fpa      , Aa^Fpa      , Aa^Fpa      , Aa^Fpa      , Aa          , Aa          , Aa          , Aa^Fpa      , Aa          , Aa^Fpa      , Aa          , Aa^Fpa      , Aa^Fda      , Aa^Fpa      , Aa^Voa      , Aa^Fpa      , Aa^Fpa      
Aa^Fpa      , Aa^Fpa      , Aa          , Aa^Fpa      , Aa^Fpa      , Aa^Fpa      , Aa^Fda      , Re          , Aa^Fpa      , Aa^Fpa      , Aa^Fpa      , Aa^Fpa      , Aa          , Aa^Fpa      , Aa^Fpa      , Aa^Fpa      , Aa^Fda      , Aa^Fpa      , Aa^Fpa      , Aa^Fpa      , Aa^Fpa      , Aa^Fda      , Aa^Fda      , Aa^Fpa      , Aa^Fpa      , Aa^Fpa      
Aa^Fpa      , Aa^Fpa      , Aa^Fpa      , Aa^Fda      , Aa          , Aa^Fpa      , Aa^Fpa      , Re          , Aa^Fpa      , Aa^Voa      , Aa^Fpa      , Aa^Fpa      , Aa^Fpa      , Aa          , Aa^Fpa      , Aa^Fpa      , Aa^Fpa      , Aa^Fpa      , Aa          , Aa          , Aa          , Aa^Fpa      , Aa^Fpa      , Aa^Fpa      , Aa          , Aa^Fpa      
Aa^Fpa      , Aa^Fpa      , Chr         , Aa^Fpa      , Aa^Fpa      , Aa^Fpa      , Aa^Fpa      , Re          , Aa^Fpa      , Aa^Fpa      , Aa          , Aa^Fpa      , Aa^Fpa      , Aa^Fpa      , Aa^Fpa      , Aa^Fda      , Aa^Fpa      , Aa^Fpa      , Aa^Fpa      , Aa^Fpa      , Aa^Fpa      , Aa^Fpa      , Aa          , Aa^Fpa      , Aa^Fpa      , Aa^Fpa      
Aa^Fpa      , Chr         , 4 Khr       , Chr         , Aa^Fpa      , Aa^Fpa      , Aa^Fpa      , Re          , Aa^Fpa      , Aa          , Aa          , Aa          , Aa^Fpa      , Aa^Fpa      , Aa^Fda      , Aa^Fpa      , Aa^Voa      , Aa^Fpa      , Aa^Fpa      , Aa          , Aa^Fpa      , Aa^Fpa      , Aa^Fpa      , Aa^Fpa      , Aa^Fpa      , Aa^Fpa      
Aa^Fpa      , Chr         , Chr         , Chr         , Aa^Fpa      , Aa^Fpa      , Aa^Fpa      , Re          , Re          , Aa^Fpa      , Aa^Fpa      , Aa^Fpa      , Aa^Fpa      , Aa^Fda      , Aa^Fpa      , Aa^Fda      , Aa^Fpa      , Aa^Fpa      , Aa^Fpa      , Aa^Fpa      , Aa^Fpa      , Aa^Fpa      , Chr         , Aa^Fpa      , Aa^Fpa      , Aa          
Aa^Fpa      , Aa^Fpa      , Aa^Fpa      , Aa^Fpa      , Aa^Fpa      , Aa          , Aa          , Aa^Fpa      , Aa^Fpa      , Re          , Aa^Fpa      , Aa^Fpa      , Aa^Fpa      , Aa          , Aa          , Aa^Fpa      , Aa^Fpa      , Aa          , Aa^Fpa      , Aa^Fpa      , Aa^Fpa      , Chr         , 3 Khr       , Chr         , Aa^Fpa      , Aa^Fpa      
Aa^Fpa      , Aa^Fpa      , Aa^Voa      , Aa^Fpa      , Aa^Fpa      , Aa          , Aa^Fpa      , Aa^Fpa      , Aa^Fpa      , Re          , Aa          , Aa^Fpa      , Aa^Fda      , Aa^Fpa      , Aa^Fpa      , Aa          , Aa^Fpa      , Aa^Fda      , Aa^Fpa      , Aa^Fpa      , Aa^Fpa      , Chr         , Chr         , Chr         , Aa^Fpa      , Aa          
Aa^Fpa      , Aa^Fpa      , Aa^Fpa      , Aa^Fda      , Aa^Fpa      , Aa^Fpa      , Aa^Fpa      , Aa^Fma      , Aa^Fma      , Re          , Re          , Aa^Fpa      , Aa^Fda      , Aa^Fda      , Aa^Fpa      , Aa^Fpa      , Aa^Fpa      , Aa^Fda      , Aa^Fda      , Aa^Fda      , Aa^Fpa      , Aa^Fpa      , Aa^Fpa      , Aa^Fpa      , Aa^Fpa      , Aa          
Ai          , Aa^Fpa      , Aa^Fda      , Aa^Fma      , Aa^Fpa      , Aa^Fpa      , Aa^Voa      , Aa^Fpa      , Aa^Fma      , Aa^Fpa      , Re          , Aa^Fpa      , Aa^Fpa      , Aa^Fda      , Aa^Fpa      , Aa^Fpa      , Aa^Fpa      , Aa^Fpa      , Aa^Fpa      , Aa^Fpa      , Aa^Fpa      , Aa^Fpa      , Aa^Fpa      , Aa^Fpa      , Aa^Fpa      , Aa^Fpa      
Ww          , Ai          , Ai          , Aa^Fpa      , Ww          , Aa^Fpa      , Ww          , Aa^Fpa      , Aa^Fpa      , Aa^Fpa      , Aa^Fpa      , Re          , Aa^Fpa      , Aa^Fpa      , Aa^Fpa      , Aa^Voa      , Aa^Fpa      , Aa^Fpa      , Aa^Fda      , Aa^Fpa      , Aa^Fpa      , Aa          , Aa^Fpa      , Aa          , Aa^Fpa      , Aa^Fma      
Aa^Fpa      , Ww          , Ai          , Ai          , Ai          , Ww          , Ai          , Ww          , Ai          , Aa^Fpa      , Aa^Fma      , Re          , Ww^Bw\      , Ai          , Ww          , Aa^Fpa      , Aa^Fda      , Aa^Fda      , Aa^Fda      , Aa^Fpa      , Aa^Fpa      , Aa^Fpa      , Aa^Fpa      , Aa          , Aa^Fpa      , Aa^Fpa      
Aa^Fpa      , Aa^Fpa      , Aa^Fpa      , Ww          , Aa^Fpa      , Ai          , Aa          , Ai          , Ww          , Ww          , Ai          , Ai          , Ai          , Ww^Bw|      , Ai          , Ai          , Ai          , Aa^Fda      , Ww          , Ai          , Ai          , Aa^Fpa      , Aa^Fpa      , Aa^Fpa      , Aa^Fpa      , Aa^Fpa      
Aa^Fpa      , Aa^Voa      , Aa^Fpa      , Aa          , Aa^Fma      , Aa^Fma      , Aa^Fma      , Aa^Fpa      , Aa^Fpa      , Ww          , Aa^Fma      , Ww          , Aa^Fma      , Re          , Aa^Fpa      , Ww          , Ai          , Ww          , Ai          , Ww          , Ai          , Ww          , Ww          , Aa^Fpa      , Aa^Fma      , Aa^Fpa      
Aa^Fpa      , Aa^Fpa      , Aa^Fpa      , Aa^Fpa      , Aa^Fpa      , Aa^Fpa      , Aa^Fpa      , Aa^Fpa      , Aa          , Aa^Fpa      , Aa^Fpa      , Aa^Fpa      , Aa^Fpa      , Re          , Re          , Aa^Fpa      , Aa^Fpa      , Ai          , Aa^Fpa      , Aa^Fpa      , Aa^Fpa      , Ai          , Ai          , Aa^Fpa      , Aa^Fma      , Aa^Fpa      
Aa^Fpa      , Aa^Fpa      , Aa^Fma      , Aa^Fpa      , Aa^Fma      , Aa          , Aa^Fma      , Aa^Fpa      , Aa^Fpa      , Aa          , Aa          , Aa^Fpa      , Aa^Fma      , Aa^Fpa      , Aa^Fpa      , Re          , Re          , Aa^Fpa      , Aa^Fpa      , Aa^Fpa      , Aa^Fpa      , Ww          , Ww          , Aa^Fpa      , Aa^Fpa      , Aa^Fpa      
Aa^Fpa      , Aa^Fpa      , Aa^Fpa      , Aa^Fma      , Aa^Fpa      , Aa^Fpa      , Aa^Voa      , Aa^Fma      , Aa^Fpa      , Aa^Fpa      , Aa^Fpa      , Aa^Fpa      , Aa          , Aa^Fpa      , Aa^Voa      , Aa^Fpa      , Re          , Aa^Fpa      , Aa^Fpa      , Aa          , Aa^Fpa      , Ai          , Ai          , Aa^Fpa      , Aa^Fpa      , Aa^Fpa      
Aa          , Aa          , Aa^Fpa      , Aa^Fma      , Aa^Fpa      , Aa^Fpa      , Aa^Fpa      , Aa^Fpa      , Aa^Fpa      , Aa^Fda      , Aa          , Aa^Fpa      , Aa^Fpa      , Aa^Fpa      , Aa^Fpa      , Re          , Aa^Fpa      , Aa^Fpa      , Aa^Fma      , Aa^Fpa      , Aa^Fpa      , Ww          , Ai          , Ww          , Aa^Fpa      , Aa^Fma      
Aa          , Aa^Fpa      , Aa^Fpa      , Aa          , Aa^Fpa      , Aa^Fma      , Aa^Fpa      , Aa^Fpa      , Aa^Fpa      , Aa^Fpa      , Aa^Fpa      , Aa^Fpa      , Aa^Fpa      , Aa          , Aa^Fpa      , Re          , Aa^Fpa      , Aa^Fma      , Aa          , Aa^Fpa      , Aa^Fpa      , Aa^Fpa      , Ww          , Ai          , Ww          , Aa^Fma      
Aa^Fda      , Aa^Fpa      , Aa^Fpa      , Aa^Fpa      , Aa          , Aa^Fpa      , Aa^Fpa      , Aa          , Aa^Fpa      , Aa^Fda      , Aa^Fpa      , Aa^Fpa      , Aa^Fma      , Aa^Fpa      , Aa^Fpa      , Re          , Aa^Fpa      , Aa^Fpa      , Aa^Fpa      , Aa          , Aa^Fpa      , Aa^Fma      , Aa^Fpa      , Ww          , Ai          , Ai          
Aa^Fpa      , Aa^Fpa      , Aa^Fpa      , Aa^Fpa      , Aa^Fpa      , Aa^Fpa      , Aa^Fpa      , Aa^Fpa      , Aa^Fpa      , Aa^Fpa      , Ce          , Aa^Fpa      , Aa^Fpa      , Aa^Fma      , Re          , Re          , Ce          , Ce          , Ce          , Aa^Fpa      , Aa          , Aa^Fpa      , Aa^Fpa      , Aa^Fpa      , Ww          , Ai          
Aa          , Aa^Fpa      , Aa^Fpa      , Aa^Voa      , Aa^Fpa      , Aa^Fpa      , Aa          , Aa^Fma      , Aa^Fpa      , Ce          , 2 Ke        , Ce          , Aa^Fma      , Re          , Aa^Fpa      , Aa^Fpa      , Ce          , 1 Ke        , Ce          , Aa^Fpa      , Aa^Fpa      , Aa^Fma      , Aa^Fpa      , Aa^Voa      , Aa^Fpa      , Ai          
Aa          , Aa          , Aa^Fpa      , Aa^Fpa      , Aa^Fpa      , Aa^Fpa      , Aa^Fpa      , Aa^Fpa      , Aa^Fpa      , Ce          , Ce          , Ce          , Aa^Fpa      , Re          , Aa^Fpa      , Aa^Fpa      , Aa^Fpa      , Ce          , Aa^Fpa      , Aa^Fpa      , Aa^Fpa      , Aa          , Aa^Fpa      , Aa^Fpa      , Aa^Fpa      , Aa^Fpa      
Aa          , Aa^Fda      , Aa          , Aa^Fpa      , Aa^Fpa      , Aa^Fpa      , Aa          , Aa          , Aa^Fpa      , Aa^Fpa      , Aa^Fpa      , Aa^Fma      , Aa^Fpa      , Re          , Aa^Fpa      , Aa          , Aa^Fpa      , Aa^Fpa      , Aa^Fpa      , Aa          , Aa^Fpa      , Aa^Fpa      , Aa^Fpa      , Aa^Fpa      , Aa          , Aa^Fpa      
