border_size=1
usage=map

Ms          , Ms          , Ms          , Ms          , Ms          , Mm          , Ms          , Ms          , Ms          , Ms          , Ms          , Ms          , Ms          , Ms          , Ms          , Ms          , Ms          , Ms          , Ms          , Ms          , Ms          , Ms          , Ms          , Ms          , Ms          , Ms          , Ms          , Ms          , Ms          , Ms          , Ww          , Ms          , Ms          , Ms          , Ms          , Ms          , Ms          , Ms          , Ms          , Ms          , Ms          , Ms          , Ms          , Ms          , Ms          , Ms          , Ms          , Ms          
Ms          , Ms          , Ms          , Ms          , Ms          , Ms          , Ms          , Ms          , Ms          , Ms          , Ms          , Ms          , Ms          , Ms          , Ms          , Ms          , Ms          , Ms          , Ms          , Ms          , Ms          , Ms          , Ms          , Ms          , Ms          , Ms          , Ms          , Ms          , Ms          , Ms          , Ai          , Ms          , Ms          , Ms          , Ms          , Ms          , Ms^Vhha     , Ms          , Ms          , Ms          , Ms          , Ms          , Ms          , Ms          , Ms          , Ms          , Ms          , Ms          
Ms          , Ms^Vhha     , Ms          , Ms          , Ms          , Ms          , Ms          , Ms^Vhha     , Ms          , Ms          , Ms          , Ms          , Ms          , Ms          , Ms          , Ms          , Ms          , Ms          , Ms          , Ms          , Ms          , Ms          , Ms          , Ms          , Ms^Vhha     , Ms          , Ms          , Ms          , Ms          , Ww          , Ms          , Ms          , Ms          , Ms          , Ms          , Ms          , Ms          , Ms          , Ms          , Ms          , Ms          , Ms          , Ms          , Ms          , Ms          , Ms^Vhha     , Ms          , Ms          
Ms          , Ms          , Ms          , Ms          , Ms          , Ms          , Ms          , Ms          , Ms          , Ms          , Ms          , Ms          , Ms          , Ms          , Ms          , Ms          , Ms          , Ms          , Ms          , Ms          , Ms          , Ms          , Ms          , Ms          , Ms          , Ms          , Ms          , Ms          , Ms          , Ww          , Ww          , Ms          , Ms          , Ms          , Ms          , Ms          , Ms          , Ms          , Ms          , Ms          , Ms          , Ms          , Ms          , Ms          , Ms          , Ms          , Ms          , Ms          
Ms          , Ms          , Ms          , Ms          , Ms          , Ms          , Ms          , Ms          , Ms          , Ms          , Ms          , Ms          , Ms          , Ms          , Ms          , Ms          , Ms          , Ms          , Ms          , Ms          , Ms          , Ms          , Ms          , Ms          , Ms          , Ms          , Ms          , Ms          , Ms          , Ms          , Ai          , Ms          , Ms          , Ms          , Ms          , Ms          , Ms          , Ms          , Ms          , Ms          , Ms          , Ms          , Ms          , Ms          , Ms          , Ms          , Ms          , Ms          
Ms          , Ms          , Ms          , Ms          , Ms          , Ms          , Ms          , Ms          , Ms          , Ms          , Ms^Vhha     , Ms          , Ms          , Ms          , Ms          , Ms          , Ms          , Ms          , Ms          , Ms          , Ms          , Ms          , Ms          , Ms          , Ms          , Ms          , Ms          , Ms          , Ms          , Ms          , Ms          , Ww          , Ms          , Ms          , Ms          , Ms          , Ms          , Ms          , Ms          , Ms          , Ms          , Ms          , Ms          , Ms          , Ms          , Ms          , Ms          , Mm          
Ms          , Ms          , Mm          , Ms          , Ms          , Ms          , Ms          , Ms          , Ms          , Ms          , Ms          , Ms          , Ms          , Ms          , Ms          , Ms          , Ms          , Ms          , Ms          , Ms^Vhha     , Ms          , Ms          , Ms          , Ms          , Ms          , Ms          , Ms          , Ms          , Ms          , Ms          , Ms          , Ai          , Ms          , Ms          , Ms          , Ms^Vhha     , Ms          , Ms          , Ms          , Ms          , Ms          , Ms          , Ms          , Ms          , Ms          , Ms          , Ms          , Ms          
Ms          , Mm          , Ms          , Ms          , Ms          , Ms          , Ms          , Ms          , Ms          , Ms          , Ms          , Ms          , Ms          , Ms          , Ms          , Ms          , Ms          , Ms          , Ms          , Ms          , Ms          , Ms          , Ms          , Ms          , Ms          , Ms          , Ms          , Ms          , Ms          , Ms          , Ms          , Ww          , Ms          , Ms          , Ms          , Ms          , Ms          , Ms          , Ms          , Ms          , Ms          , Ms          , Ms          , Ms^Vhha     , Ms          , Ms          , Ms          , Ms          
Ms          , Ms          , Ms          , Ms          , Ms          , Ms          , Ms          , Mm          , Ms          , Ms          , Ms          , Mm          , Ms          , Ms          , Ms^Vhha     , Ms          , Ms          , Ms          , Ms          , Ms          , Ms          , Ms          , Ms          , Ms          , Ms          , Ms          , Ms          , Ms          , Ms^Vhha     , Ms          , Ms          , Ww          , Ms          , Ms          , Ms          , Ms          , Ms          , Ms          , Ms          , Ms          , Ms          , Ms          , Ms          , Ms          , Ms          , Ms          , Ms          , Ms          
Ms          , Ms^Vhha     , Ms          , Ms          , Ms          , Mm          , Ms          , Ms^Vhha     , Ms          , Ms          , Ms          , Mm          , Mm          , Ms          , Mm          , Ms          , Ms          , Ms          , Ms          , Ms          , Ms          , Ms          , Ms          , Ms          , Aa^Fpa      , Ms          , Aa^Fpa      , Ms          , Ms          , Ms          , Aa^Fpa      , Ai          , Ww          , Ha^Fda      , Ha^Fda      , Ms          , Ha^Fda      , Ms          , Ms          , Ms          , Mm          , Ms          , Mm          , Ms          , Ha^Fda      , Ms          , Aa^Fpa      , Mm          
Ha^Fda      , Ms          , Ha^Fda      , Ms          , Ha^Fda      , Ms          , Ms          , Ms          , Hh^Fdf      , Ha^Fma      , Ha^Fda      , Ha^Fda      , Ha          , Ms          , Ha          , Ms          , Ha          , Ha          , Hh          , Ha^Fda      , Ha^Fda      , Ha^Fda      , Aa^Fpa      , Aa^Fpa      , Ai          , Ww          , Ww          , Ai          , Ww          , Ww          , Ai          , Aa          , Aa^Fda      , Ww          , Ai          , Ha^Fda      , Ha^Fda      , Mm          , Ha^Fda      , Ha^Fda      , Ha^Fda      , Ha^Fda      , Ha^Fpa      , Ha^Fda      , Ha^Fda      , Ha^Fda      , Aa^Fpa      , Aa^Fpa      
Hh^Fdw      , Ha^Fda      , Hh          , Hh^Fdw      , Ha^Fda      , Hh          , Ha^Fma      , Ha^Fda      , Ha          , Ha^Fma      , Ha^Fma      , Ha^Fda      , Hh^Fdf      , Ha          , Hh^Fdw      , Ha^Fda      , Ha^Fda      , Ha^Fda      , Ha          , Ha          , Aa          , Aa          , Ww          , Ww          , Ch          , Ch          , Ch          , Ch          , Ch          , Ch          , Ch          , Ww          , Ai          , Aa          , Ai          , Ha^Fda      , Hh^Fdw      , Ha^Fda      , Hh^Fdf      , Ha^Fda      , Hh          , Ha^Fda      , Hh^Fp       , Hh          , Hh^Fdw      , Aa^Fpa      , Aa^Fpa      , Aa^Fpa      
Hh^Fdw      , Hh^Fdf      , Re^Vct      , Ha^Fda      , Hh          , Ha          , Ha^Fma      , Hh          , Ha          , Ha          , Hh          , Ha^Fma      , Gg          , Gg          , Gg          , Gg          , Gg          , Gg          , Gg          , Gg          , Ww          , Ai          , Ch          , Ch          , Rr          , Rr          , Rr          , Rp^Vhc      , Rp          , Rr          , Rp          , Ch          , Ch          , Ww          , Ai          , Hh^Fdw      , Hh^Fdf      , Ha^Fpa      , Hh^Fp       , Ha^Fda      , Aa^Fpa      , Chr         , Aa^Fpa      , Aa^Fpa      , Hh^Fp       , Hh^Fp       , Aa^Fpa      , Hh^Fp       
Hh^Fdf      , Ha^Fda      , Ha^Fda      , Hh          , Ha          , Ha          , Ha          , Ha          , Ha          , Ha          , Ha          , Gg          , Gg          , Chr         , Aa          , Gg          , Gg          , Aa          , Aa          , Gg          , Ai          , Ch          , Rr          , Rr          , Rr          , Rp          , Ch          , Rp          , Ch          , Rp          , Rp          , Rp^Vhc      , Rp          , Ch          , Ww^Bw\      , Aa^Fpa      , Rr          , Aa^Fpa      , Rp          , Aa^Fpa      , Rr          , Aa^Fpa      , Rr          , Aa^Fpa      , Rr          , Aa^Fpa      , Rr          , Aa^Fpa      
Ha^Fda      , Hh          , Ce          , Ce          , Ce          , Gg          , Gg          , Re^Vct      , Gg          , Gg          , Gg          , Gg          , Aa          , Gg          , Aa^Vha      , Aa          , Gg          , Aa          , Gg          , Aa          , Ww^Bw/      , Ch          , Rr          , Rp^Vhc      , Rp          , Ch          , Rp^Vhc      , Ch          , Rp^Vhc      , Ch          , Rp          , Rp          , Rp          , Ch          , Ww^Bw\      , Rr          , Rr          , Rr          , Rr          , Rp          , Rr          , Rr          , Rr          , Rr          , Rr          , Rr          , Rr          , Rr          
Rp          , Gg          , Ce          , 3 Ke        , Ce          , Gg          , Gg          , Gg          , Rr          , Aa          , Rr          , Aa          , Rp          , Aa          , Rp          , Rp          , Rp          , Rp          , Rp          , Rp          , Ww^Bw/      , Ch          , Rr          , Rr          , Rp          , Ch          , Rp^Vhc      , 2 Kh        , Rp^Vhc      , Ch          , Rp          , Rp^Vhc      , Rp          , Ch          , Ww^Bw\      , Rr          , Rr          , Rr          , Rr          , Rr          , Rp          , Rr          , Rr          , Rr          , Rr          , Rr          , Rr          , Rr          
Ha^Fda      , Rp          , Rr          , Ce          , Aa          , Aa          , Rr          , Rr          , Aa          , Rr          , Aa          , Rr          , Rp          , Rp          , Rp          , Rp          , Gg          , Rp          , Gg          , Rp          , Ww          , Ch          , Rr          , Rp^Vhc      , Rp          , Ch          , Ch          , Ch          , Ch          , Ch          , Rp          , Rp          , Rp          , Ch          , Ai          , Rp          , Aa          , Rr          , Ha^Fpa      , Rp          , Ha^Fpa      , Rr          , Ha          , Rr          , Ha          , Rr          , Ha          , Rr          
Ha^Fda      , Hh          , Ha^Fpa      , Rr          , Rr          , Rr          , Aa^Fda      , Gg          , Aa          , Aa          , Gg          , Gg          , Rp          , Rp          , Aa          , Gg          , Gg          , Gg          , Ha^Fda      , Gg          , Ai          , Ch          , Ch          , Rp          , Rp          , Rp          , Rp          , Rp          , Rp          , Rp          , Rp          , Rp          , Ch          , Ch          , Ww          , Aa          , Gg          , Hh^Fp       , Ha^Vhha     , Ha^Fpa      , Ha^Fda      , Ha          , Ha^Fda      , Ha^Fda      , Ha^Fda      , Ha^Fda      , Ha^Fda      , Hh          
Hh^Fdw      , Ha^Fda      , Hh          , Hh^Fdw      , Aa^Fda      , Re^Vct      , Aa^Fda      , Gg          , Aa          , Aa          , Aa          , Rp          , Gg          , Gg          , Gg          , Gg          , Ha^Fda      , Ha^Fda      , Aa^Fpa      , Gg          , Gg         , Ww          , Ai          , Ch          , Ch          , Rp          , Ch          , Rp^Vhc      , Ch          , Rp          , Ch          , Ch          , Ai          , Ww          , Gg          , Gg          , Gg          , Ha          , Hh          , Ha^Fpa      , Ms          , Ms          , Ms          , Ms          , Chr         , Ms          , Ms          , Ms          
Ha          , Ha^Fpa      , Ha^Fpa      , Aa^Fda      , Aa^Fda      , Ha^Vhha     , Hh^Fdf      , Aa          , Gg          , Aa          , Aa          , Rp          , Gg          , Gg^Vh       , Gg          , Aa^Fpa      , Ms          , Aa^Fma      , Ha^Fda      , Ha^Fda      , Gg          , Aa          , Aa          , Ai          , Ww          , Ch          , Ww^Bw|      , Ch          , Ww^Bw|      , Ch          , Ww          , Ai          , Gg          , Gg          , Aa          , Aa          , Aa          , Hh^Fp       , Ha^Fpa      , Ms          , Ms          , Ms          , Ms          , Ms          , Ms          , Ms          , Mm          , Ms          
Rp          , Rp          , Rp          , Hh^Fdw      , Ha          , Hh^Fdf      , Aa          , Gg          , Chr         , Gg          , Aa          , Rp          , Gg          , Aa          , Aa          , Aa^Fpa      , Aa^Fpa      , Ms          , Aa^Fpa      , Gg          , Gg          , Aa          , Gg          , Aa          , Gg         , Ww          , Rr          , Ww^Bw|      , Rr          , Ww          , Gg          , Aa          , Aa          , Aa          , Gg          , Gg          , Aa          , Gg          , Ha^Fpa      , Ha^Fpa      , Ms          , Ms          , Mm          , Mm          , Mm          , Mm          , Mm          , Ms          
Hh^Fdw      , Ha^Fda      , Ha^Fpa      , Rp          , Rp          , Rp          , Rp          , Aa          , Aa          , Aa          , Rp          , Rp          , Gg          , Gg          , Aa          , Hh^Fdw      , Aa^Fma      , Ms          , Aa^Fma      , Aa^Fma      , Gg          , Gg          , Aa          , Gg          , Gg          , Gg         , Rr          , Rr          , Rr          , Gg          , Aa          , Gg          , Aa          , Gg          , Gg          , Chr         , Gg          , Hh^Fp       , Ha^Fpa      , Ha          , Ms          , Ms^Vhha     , Mm          , Mm          , Ce          , Mm          , Ms          , Mm          
Ha^Fda      , Hh^Fdf      , Ms          , Ha^Fpa      , Hh^Fdf      , Ha^Fda      , Gg          , Rp          , Rp          , Aa          , Rp          , Gg          , Gg          , Aa          , Gg          , Aa^Fpa      , Aa^Fma      , Ms          , Aa^Fpa      , Aa^Fpa      , Gg          , Gg          , Gg          , Aa          , Aa          , Gg          , Rr          , Rr          , Rr          , Aa          , Gg          , Gg          , Gg          , Gg          , Gg          , Gg          , Aa          , Gg          , Hh          , Ha^Fpa      , Ms          , Mm          , Mm          , Ce          , 5 Ke        , Ce          , Mm          , Ms          
Hh^Fdf      , Ms          , Ms^Vhha     , Hh          , Ce          , Ce          , Ce          , Aa          , Re^Vct      , Rp          , Rp          , Aa          , Aa          , Gg          , Ha^Fda      , Aa^Fma      , Ha^Fda      , Ha^Fda      , Ha^Fda      , Gg          , Gg          , Gg          , Gg          , Aa          , Aa^Vha      , Aa          , Rr          , Rr          , Rr          , Aa          , Gg          , Aa^Vha      , Aa          , Gg          , Gg          , Aa          , Ai          , Ww          , Ha^Fpa      , Ha^Fpa      , Ms          , Mm          , Mm          , Ce          , Ce          , Ce          , Mm          , Ms          
Hh^Fp       , Ms          , Ms          , Ms          , Ce          , 4 Ke        , Ce          , Aa          , Gg          , Aa          , Gg          , Rp          , Rp          , Gg          , Gg          , Gg          , Gg          , Ha^Fda      , Gg          , Gg          , Aa          , Aa          , Gg          , Gg          , Aa          , Aa          , Rr          , Rr          , Rr          , Gg          , Gg          , Aa          , Gg          , Gg          , Aa          , Gg          , Ww          , Ww          , Hh^Fp       , Ha^Fpa      , Ms          , Ms          , Ms          , Mm          , Ms          , Mm          , Ms          , Ms          
Ms          , Ms          , Ha^Fpa      , Ms          , Hh^Fdw      , Ce          , Aa          , Ai          , Ai          , Chr         , Chr         , Aa          , Aa          , Rp          , Rp          , Gg          , Gg          , Gg          , Aa          , Aa          , Rp          , Aa          , Aa          , Aa          , Gg          , Aa          , Rr          , Rr          , Rr          , Gg          , Aa          , Aa          , Gg          , Gg          , Gg          , Gg          , Gg          , Ww          , Ha          , Ha^Fda      , Ms          , Ms          , Mm          , Ms          , Ms          , Ms          , Ha^Fda      , Ms          
Hh          , Ha^Fpa      , Ha^Fpa      , Ha^Fpa      , Ha^Fda      , Gg          , Aa          , Aa          , Aa          , Gg          , Aa          , Gg          , Aa          , Aa          , Gg          , Rp          , Rp          , Aa          , Rp          , Rp          , Gg          , Rp          , Rp          , Gg          , Aa          , Aa          , Rr          , Rr          , Rr          , Rr          , Rr          , Gg          , Gg          , Ch          , Gg          , Aa          , Gg          , Hh^Fp       , Hh^Fp       , Ha^Fda      , Ha          , Ms          , Ha^Fda      , Ha^Fda      , Ha^Fpa      , Hh^Fdw      , Ha^Fda      , Ha^Fpa      
Rp          , Hh^Fdw      , Rp          , Ha^Fda      , Rp          , Rp          , Rp          , Re^Vct      , Rp          , Rp          , Rp          , Rp          , Rp          , Aa          , Rp          , Rp          , Aa          , Rp          , Gg          , Gg          , Aa          , Gg          , Gg          , Rp          , Rp          , Aa          , Rr          , Rr          , Rp          , Rr          , Rr          , Rr          , Rr          , Gg          , Gg          , Aa          , Aa          , Gg          , Ha          , Ha          , Ha^Vhha     , Ha^Fpa      , Ha^Fpa      , Ha^Fda      , Ha^Fpa      , Ha^Fpa      , Ha^Fpa      , Ha^Fda      
Ha^Fda      , Rp          , Ha^Fda      , Rp          , Ha^Fda      , Ha^Fda      , Ha^Fda      , Rp          , Ha^Fda      , Ha^Fpa      , Hh          , Ha^Fpa      , Ha^Fpa      , Rp          , Gg          , Aa          , Rp          , Rp          , Gg          , Aa          , Ai          , Gg          , Ai          , Aa          , Gg          , Rp          , Rp          , Rp          , Aa          , Gg          , Gg          , Rr          , Rr          , Rr          , Rr          , Gg          , Gg          , Ha^Fpa      , Ha          , Hh^Fp       , Ha          , Ha          , Hh^Fp       , Ha^Fda      , Ha^Fpa      , Hh^Fdw      , Hh^Fp       , Ha          
Ms          , Ha^Fda      , Hh^Fdf      , Hh          , Ha^Fpa      , Ha^Vhha     , Hh^Fdw      , Hh          , Ha^Fda      , Hh          , Ms          , Ha^Fda      , Hh          , Hh^Fdf      , Hh^Fdw      , Aa          , Rp          , Aa          , Aa          , Aa          , Ai          , Ai          , Ai          , Aa          , Aa          , Gg          , Aa          , Aa          , Gg          , Gg          , Gg          , Aa          , Gg          , Rr          , Rr          , Rr          , Rp          , Hh          , Ha^Fpa      , Hh^Fp       , Ha^Fpa      , Ha^Fda      , Ha^Fpa      , Ha^Fda      , Ha^Fpa      , Ha^Fpa      , Ha^Fpa      , Ha          
Ms          , Hh          , Hh^Fdf      , Ha^Fpa      , Ms          , Ha^Fpa      , Ha^Fpa      , Hh^Fdw      , Hh^Fdw      , Ha^Fda      , Ms          , Ms          , Ms          , Ha^Fda      , Hh^Fdf      , Rp          , Aa          , Gg          , Aa^Vha      , Gg          , Ai          , Ai          , Gg          , Gg          , Gg          , Gg          , Gg          , Aa          , Gg^Vh       , Gg          , Aa          , Aa          , Gg          , Aa          , Aa          , Rp          , Rp          , Rp          , Rp          , Rp          , Rp          , Ha^Fpa      , Rp          , Ha^Fpa      , Rp          , Ha^Fpa      , Rp          , Rp          
Ms          , Ms          , Ms          , Ms          , Ms          , Hh^Fdf      , Ms          , Hh^Fdw      , Ha^Fda      , Ha^Fda      , Ms          , Ms^Vhha     , Ms          , Ha^Fpa      , Ha^Fpa      , Rp          , Gg          , Gg          , Gg          , Gg          , Gg          , Gg          , Aa^Fpa      , Aa^Fda      , Aa^Fda      , Gg          , Gg          , Aa          , Gg          , Gg          , Ce          , Gg          , Gg          , Gg          , Aa          , Gg          , Aa          , Rp          , Ha^Fpa      , Hh^Fp       , Ha^Fpa      , Rp          , Hh^Fp       , Rp          , Ha^Fpa      , Rp          , Ha^Fpa      , Rp          
Ms          , Mm          , Ms          , Hh^Fdf      , Ms          , Ms          , Hh^Fdw      , Ha^Fda      , Ha^Fda      , Ms          , Ms          , Ms          , Hh^Fdf      , Ha^Fda      , Hh^Fdf      , Rp          , Gg          , Gg          , Aa          , Gg          , Gg          , Gg          , Aa^Fda      , Gs^Fdw      , Aa^Fda      , Aa^Fpa      , Gg          , Gg          , Gg          , Ce          , 1 Ke        , Ce          , Gg          , Gg          , Gg          , Aa          , Gg          , Rp          , Hh^Fp       , Ha^Fpa      , Hh^Fp       , Ha^Fpa      , Hh^Fp       , Ha^Fpa      , Ha^Fpa      , Ha^Fpa      , Aa^Fma      , Hh^Fp       
Mm          , Ms          , Ha^Fda      , Hh          , Hh          , Ha^Fpa      , Ha^Fpa      , Hh^Fdf      , Hh^Fdf      , Hh          , Ms          , Ms          , Hh^Fdf      , Hh^Fdw      , Rp          , Rp          , Gg          , Aa          , Gg          , Aa          , Gs^Fdw      , Aa^Fpa      , Aa^Fda      , Ha^Fda      , Aa^Fda      , Aa^Fpa      , Gs^Fdw      , Gg          , Gg          , Ce          , Ce          , Ce          , Gg          , Gg^Vh       , Gg          , Gg          , Gg          , Rp          , Aa^Fma      , Aa^Fma      , Aa^Fma      , Ha^Fpa      , Hh^Fp       , Ha^Fpa      , Hh^Fp       , Aa^Fma      , Hh^Fp       , Ha^Fpa      
Ms          , Ms          , Hh^Fds      , Hh^Fdf      , Hh          , Ha^Fda      , Hh^Fdw      , Ha^Fda      , Hh^Fdw      , Ha^Fpa      , Ha^Fpa      , Hh^Fdw      , Hh^Fdw      , Ha^Fda      , Hh^Fdw      , Rp          , Gg          , Aa          , Gg          , Gs^Fdw      , Aa^Fpa      , Gs^Fdw      , Gs^Fdw      , Ha^Fda      , Gs^Fdw      , Aa^Fpa      , Aa^Fpa      , Gg          , Gg          , Aa          , Aa          , Aa          , Gg          , Gg          , Aa          , Aa          , Aa          , Rp          , Hh^Fp       , Aa^Fma      , Hh^Fp       , Aa^Fma      , Hh^Fp       , Ha^Fpa      , Hh^Fp       , Aa^Fma      , Hh^Fp       , Ha^Fpa      
