border_size=1
usage=map

Hh          , Ha          , Hh          , Hh          , Aa^Fpa      , Hh          , Aa^Fda      , Hh          , Hh          , Hh          , Hh          , Ww          , Hh          , Ms          , Mm          , Ms          , Mm          , Ms          , Ms          , Ms          , Mm          , Ms          , Mm          , Mm          , Mm          , Mm          , Mm          
Gs^Fdw      , Hh^Vo       , Gs^Fdw      , Gs^Fp       , Gs^Fp       , Gs^Fp       , Gs^Fdw      , Aa^Fpa      , Gs^Fp       , Aa^Fpa      , Ww          , Ww          , Aa^Fpa      , Mm          , Ha^Fda      , Hh          , Gs^Fdw      , Ha          , Hh          , Mm          , Gs^Fdw      , Hh          , Hh          , Gs^Fdw      , Gs^Fdw      , Hh          , Hh          
Gs^Fp       , Gs^Fp       , Gs^Fp       , Gs^Fp       , Gs^Fp       , Gs^Fp       , Gs^Fp       , Gs^Fp       , Gs^Fp       , Ww          , Gs^Fp       , Gs^Fp       , Gs^Fp       , Hh          , Gs^Fp       , Aa^Fpa      , Gg          , Gs^Fdw      , Gg          , Hh          , Gg          , Gg          , Gg          , Gg          , Rd          , Gs^Fdw      , Rd          
Gg          , Gg          , Gg          , Gg          , Gg          , Gs^Fp       , Gg          , Gs^Fp       , Gg          , Ww          , Gs^Fp       , Gs^Fp       , Gs^Fp       , Gg          , Gs^Fp       , Gs^Fp       , Gs^Fp       , Gg          , Gg          , Gg^Vo       , Gg          , Gg          , Rd          , Rd          , Gg          , Rd          , Gg          
Co          , Co          , Co          , Gg          , Gg          , Gg          , Gg^Vo       , Gg          , Gg          , Ww          , Gg          , Gg          , Gg          , Gs^Fp       , Gg          , Gs^Fp       , Gg          , Gg          , Gg          , Gg          , Rd          , Rd          , Co          , Co          , 6 Ko        , Co          , Gg          
Co          , 5 Ko        , Co          , Gg          , Aa          , Gg          , Gg          , Gg          , Ww          , Ww          , Aa          , Gg          , Gg          , Gg          , Gg          , Gg          , Gg          , Gg          , Gg          , Rd          , Gs^Fp       , Gs^Fp       , Gg          , Co          , Co          , Co          , Gg          
Gg          , Co          , Gg          , Gg          , Aa          , Gg          , Gs^Fp       , Gg          , Ww          , Gg          , Gg          , Aa          , Gg          , Gg          , Gg^Vo       , Gg          , Gg          , Gg          , Gg          , Rd          , Gs^Fp       , Gg          , Gg^Vo       , Gg          , Gg          , Gg          , Hh^Fp       
Gg          , Gg          , Gg          , Aa          , Gg          , Gg          , Gs^Fp       , Gg          , Gs^Fp       , Ww          , Ww          , Aa          , Gg          , Gg          , Gg          , Gg          , Gs^Fp       , Gg          , Gs^Fp       , Rd          , Gg          , Gg          , Gg          , Gg          , Hh^Fp       , Hh^Fp       , Hh          
Gg          , Gg          , Gg          , Gg          , Gg          , Gg          , Gg          , Gg          , Gg          , Gg          , Ww          , Gg          , Gg          , Gg          , Gg          , Gg          , Gg          , Gs^Fp       , Gg          , Rd          , Gg          , Gg          , Hh^Fp       , Gg          , Hh          , Hh          , Hh^Fp       
Gg          , Gg^Vo       , Gg          , Gs^Fp       , Gs^Fp       , Gg          , Gg          , Gs^Fp       , Gg^Vo       , Gg          , Ww          , Ww          , Ww          , Gg          , Gg          , Gg          , Gg          , Gg          , Rd          , Rd          , Gg          , Gg          , Hh          , Hh          , Gs^Fdw      , Hh          , Hh^Vo       
Rd          , Gg          , Gs^Fp       , Gs^Fp       , Gg          , Gg          , Gs^Fp       , Gg          , Gg          , Ww          , Co          , Co          , 3 Ko        , Ww          , Ww          , Gg          , Rd          , Rd          , Gg          , Gg          , Gg          , Hh          , Gs^Fdw      , Hh          , Gs^Fdw      , Hh          , Gs^Fdw      
Gg          , Rd          , Rd          , Rd          , Rd          , Rd          , Rd          , Rd          , Rd          , Ww          , Co          , Gg^Vo       , Co          , Co          , Co          , Ww^Bw/      , Ww          , Gg          , Gg          , Gg          , Gg          , Aa          , Hh          , Hh          , Gg          , Hh^Fp       , Hh^Fp       
Gg          , Gg          , Gg          , Gg          , Gg          , Gg          , Aa          , Gg          , Gg          , Ww^Bw\      , Co          , Co          , Co          , Gg^Vo       , Gg^Vo       , Co          , Ww          , Gg          , Aa          , Gg          , Gg          , Gg          , Gg          , Hh^Fp       , Gg          , Gg          , Gg          
Gg          , Gg          , Gg          , Gs^Fp       , Gs^Fp       , Gg          , Gg^Vo       , Aa          , Gg          , Ww          , Co          , Gg^Vo       , Gg^Vo       , Co          , Co          , Co          , Ww          , Gg          , Aa          , Gg          , Gg^Vo       , Gg          , Gg          , Gg          , Co          , Gg          , Gg          
Gg          , Gs^Fp       , Gs^Fp       , Gs^Fp       , Gg          , Gg          , Gs^Fp       , Gg          , Gg          , Ww          , Ww          , Co          , Co          , Ww          , Ww          , Co          , Ww          , Gg          , Gg          , Aa          , Gg          , Gg          , Co          , Gs^Fp       , Gs^Fp       , Gg          , Gg          
Gg          , Gg          , Gg          , Gs^Fp       , Aa          , Aa          , Gs^Fp       , Gs^Fp       , Gg          , Gg          , Ww          , 4 Ko        , Ww          , Ww          , Gg          , Ww          , Gg          , Ww          , Gg          , Gg          , Aa          , Gg          , Gg          , Co          , Gg          , Gs^Fp       , Gg          
Gs^Fp       , Gs^Fp       , Gs^Fp       , Gs^Fp       , Aa^Fpa      , Gs^Fp       , Gs^Fp       , Gg          , Ww          , Ww^Bw\      , Gg          , Ww          , Gg          , Gg          , Gg          , Gg          , Ww          , Ww          , Gg          , Aa          , Gg          , Gg          , Gs^Fp       , Gg          , Gs^Fp       , Gg          , Gg          
Gs^Fp       , Gg^Vo       , Gs^Fp       , Gs^Fp       , Gs^Fp       , Aa^Fpa      , Gs^Fp       , Gs^Fp       , Ww          , Gg          , Gg          , Gg          , Gg          , Gg          , Aa          , Gg          , Gg          , Ww          , Ww          , Gg          , Gg          , Gg          , Gg          , Gs^Fp       , Gs^Fp       , Gs^Fp       , Gg          
Gs^Fp       , Gs^Fp       , Gs^Fp       , Gs^Fp       , Gg^Vo       , Gs^Fp       , Gs^Fp       , Ww          , Gg          , Gg          , Gg          , Gg          , Gs^Fp       , Gg          , Gs^Fp       , Gg^Vo       , Gg          , Gg          , Gg          , Ww          , Ww          , Gg          , Gg          , Gs^Fp       , Gg          , Gg          , Gg          
Gs^Fp       , Gs^Fp       , Gs^Fp       , Gs^Fp       , Gs^Fp       , Gs^Fp       , Ww          , Ww          , Gg          , Gg          , Gg          , Gs^Fp       , Gg          , Gg          , Gg          , Gg          , Gg          , Gg          , Gg          , Gg          , Gg^Vo       , Ww          , Ww          , Gg          , Gg          , Gg^Vo       , Gg          
Gs^Fp       , Aa^Fpa      , Gs^Fp       , Gs^Fp       , Gs^Fp       , Aa^Fpa      , Ww          , Gg          , Gg          , Gg          , Gg          , Gg          , Gg          , Gg          , Gg          , Gg          , Gg          , Gg          , Hh^Fdw      , Gg          , Gg          , Gg          , Gg          , Ww          , Ww          , Gg          , Gg          
Gs^Fp       , Gs^Fp       , Gs^Fp       , Gs^Fp       , Gs^Fp       , Gs^Fp       , Ww          , Gg          , Gg          , Gg^Vo       , Gg          , Hh^Fp       , Hh^Fp       , Hh^Fdw      , Hh^Fp       , Hh^Fdw      , Hh^Fdw      , Hh^Fdw      , Hh^Fdw      , Gg          , Gs^Fdw      , Gg          , Hh^Fdw      , Gg          , Ww          , Gs^Fp       , Gs^Fp       
Gs^Fp       , Gs^Fp       , Gs^Fp       , Gs^Fp       , Gs^Fp       , Gs^Fp       , Ww          , Gg          , Gs^Fdw      , Hh^Fp       , Hh^Fmw      , Hh^Fp       , Gs^Fdw      , Hh^Fp       , Gs^Fdw      , Ha^Fda      , Mm          , Hh^Vo       , Mm          , Hh^Fdw      , Hh^Fdw      , Hh^Fdw      , Hh^Fdw      , Hh^Fdw      , Ww          , Gg          , Gg          
Gs^Fp       , Aa^Fpa      , Gs^Fp       , Gs^Fp       , Gs^Fp       , Gs^Fp       , Ww          , Hh^Fp       , Ha^Fpa      , Hh^Fmw      , Hh^Vo       , Hh^Fmw      , Gs^Fdw      , Mm          , Mm          , Mm          , Mm          , Mm          , Mm          , Ha^Fda      , Hh^Fp       , Hh^Fdw      , Hh^Fdw      , Hh^Fdw      , Ww          , Gs^Fp       , Gg          
Gs^Fp       , Aa^Fpa      , Gg^Vo       , Aa^Fpa      , Aa^Fpa      , Gs^Fp       , Ww          , Hh^Fp       , Hh^Fp       , Hh^Fmw      , Hh^Fmw      , Hh^Fmw      , Gs^Fdw      , Gs^Fdw      , Ms          , Ha^Fda      , Ms          , Ms          , Mm          , Ha^Fda      , Hh^Fdw      , Ha^Fma      , Ha^Fma      , Hh          , Gs^Fdw      , Ww          , Ww          
Gs^Fp       , Gs^Fp       , Gs^Fp       , Gs^Fp       , Gs^Fp       , Gs^Fp       , Ww          , Hh^Fp       , Hh^Fp       , Hh^Fp       , Hh^Fp       , Hh^Fp       , Gs^Fdw      , Ha^Fda      , Mm          , Ms          , Mm          , Ms          , Mm          , Hh^Fdw      , Hh^Fdw      , Hh^Fdw      , Hh^Fdw      , Hh          , Hh          , Hh          , Hh          
Gs^Fp       , Gs^Fp       , Gs^Fp       , Gs^Fp       , Gs^Fp       , Gs^Fp       , Ww          , Hh^Fmw      , Hh^Fmw      , Hh          , Hh          , Hh^Fmw      , Hh^Fmw      , Mm          , Mm          , Mm          , Hh^Fdf      , Hh^Fdf      , Hh^Fdf      , Mm          , Mm          , Hh^Fdf      , Hh^Vo       , Hh^Fmw      , Hh^Fmw      , Hh          , Hh^Fdw      
Gs^Fp       , Gs^Fp       , Gs^Fp       , Gs^Fp       , Gs^Fp       , Gs^Fp       , Ww          , Hh^Fmw      , Hh^Fmw      , Ha^Fda      , Hh^Fdf      , Hh^Fmw      , Mm          , Ms          , Hh^Fdw      , Mm          , Hh^Vo       , Mm          , Mm          , Ms          , Mm          , Hh^Fdf      , Hh          , Ha^Fda      , Ce          , Hh^Fdw      , Hh^Fdw      
Gs^Fp       , Gs^Fp       , Gs^Fp       , Gs^Fp       , Gs^Fp       , Gs^Fp       , Ww          , Hh^Fmw      , Hh^Fmw      , Hh^Fmw      , Hh^Fdf      , Hh^Fdf      , Mm          , Mm          , Ce          , Mm          , Mm          , Mm          , Hh^Fdf      , Mm          , Hh^Fmw      , Hh^Fdf      , Hh          , Ce          , 1 Ke        , Ce          , Ha^Fma      
Gs^Fp       , Gs^Fp       , Gs^Fp       , Gs^Fp       , Gs^Fp       , Ww          , Hh^Fmw      , Ha^Fda      , Ha^Fda      , Hh^Vo       , Hh^Fdf      , Ms          , Hh^Fdw      , Ce          , 2 Ke        , Ce          , Mm          , Mm          , Mm          , Mm          , Hh^Fdf      , Hh^Fmw      , Hh^Fmw      , Ce          , Ce          , Ce          , Hh^Fdw      
Gs^Fp       , Gs^Fp       , Gg^Vo       , Gs^Fp       , Gs^Fp       , Ww          , Hh^Fmw      , Ha^Fda      , Ha^Fda      , Hh^Fdf      , Ms          , Mm          , Mm          , Ce          , Ce          , Ce          , Mm          , Mm          , Ms          , Hh^Fdf      , Mm          , Hh^Fdf      , Ha^Fda      , Hh^Fmw      , Hh^Fmw      , Ha^Fma      , Hh^Fdw      
Gs^Fp       , Gs^Fp       , Gs^Fp       , Gs^Fp       , Ww          , Ww          , Hh^Fmw      , Hh^Vo       , Hh^Fmw      , Ms          , Hh^Fdw      , Ms          , Mm          , Hh^Fdw      , Mm          , Ms          , Hh^Fdf      , Ms          , Mm          , Hh^Fdf      , Ms          , Hh^Fdf      , Hh^Vo       , Ha^Fda      , Hh^Fmw      , Hh          , Hh^Fdw      
Gs^Fp       , Gs^Fp       , Gs^Fp       , Gs^Fp       , Ww          , Ha^Fda      , Ha^Fda      , Ha^Fda      , Ha^Fda      , Mm          , Mm          , Ms          , Mm          , Mm          , Mm          , Mm          , Mm          , Ms          , Mm          , Ms          , Mm          , Hh^Fmw      , Hh^Fmw      , Hh^Fmw      , Hh^Fmw      , Hh^Fdw      , Hh^Fdw      
