border_size=1
usage=map

Gs^Fdw      , Gs^Fdw      , Gs^Fdw      , Gs^Fdw      , Gs^Fdw      , Gs^Fdw      , Gs^Fdw      , Gg          , Ss          , Gg          , Ss          , Ss          , Ss          , Ww          , Ww          , Ss          , Gs^Fdw      , Gs^Fdw      , Gs^Fdw      , Ww          , Ss          , Gg          , Gs^Fdw      , Gs^Fdw      , Gs^Fdw      , Hh^Fdw      , Hh^Fdw      , Hh^Fdw      
Gs^Fdw      , Gg^Vo       , Gs^Fdw      , Gs^Fdw      , Gg          , Gs^Fdw      , Gg          , Ss          , Ss          , Ss^Vhs      , Gs^Fdw      , Gg          , Gg          , Ww          , Ww          , Ss          , Gg          , Gs^Fdw      , Ss          , Ww          , Ss          , Gg          , Gs^Fdw      , Gs^Fdw      , Gs^Fdw      , Hh^Fdw      , Hh^Vo       , Hh^Fdw      
Gs^Fdw      , Gs^Fdw      , Gs^Fdw      , Gs^Fdw      , Gg          , Ss          , Chr         , Ss          , Gg          , Ss          , Gs^Fdw      , Gs^Fdw      , Ss          , Ss          , Ww          , Ww          , Ss^Vhs      , Gs^Fdw      , Gs^Fdw      , Ww          , Ss          , Gg          , Gs^Fdw      , Gs^Fdw      , Ce          , Hh^Fdw      , Hh^Fdw      , Hh^Fdw      
Gg          , Gs^Fdw      , Gs^Fdw      , Gs^Fdw      , Ss          , Chs         , 2 Khs       , Chr         , Gs^Fdw      , Gs^Fdw      , Gg          , Ss          , Gg          , Ww          , Ww          , Ww          , Ss          , Gs^Fdw      , Gs^Fdw      , Ww          , Gg          , Ss          , Gg          , Ce          , 1 Ke        , Ce          , Hh^Fdw      , Hh^Fdw      
Gs^Fdw      , Gs^Fdw      , Gs^Fdw      , Gs^Fdw      , Ss          , Chs         , Chs         , Chr         , Gs^Fdw      , Gs^Fdw      , Ss          , Ss          , Ss          , Ww          , Ww          , Ww          , Gs^Fdw      , Gs^Fdw      , Ww          , Ww          , Ss          , Ss^Vhs      , Gg          , Ce          , Ce          , Ce          , Re          , Re          
Gs^Fdw      , Gs^Fdw      , Gg          , Gg          , Ss          , Gs^Fdw      , Gg          , Ss          , Gs^Fdw      , Gg          , Gg          , Ss          , Ss          , Ss          , Ww          , Ww          , Ww          , Gs^Fdw      , Ww          , Gg          , Gg          , Gg          , Gg          , Gg          , Hh^Fdw      , Re          , Gs^Fdw      , Gs^Fdw      
Gg          , Gs^Fdw      , Gs^Fdw      , Gs^Fdw      , Gg          , Gg          , Gs^Fdw      , Gg          , Gg          , Gs^Fdw      , Ss          , Gg          , Gg          , Ss          , Ww          , Ww          , Ww          , Ww          , Ww          , Ss          , Ss          , Gg          , Gs^Fdw      , Hh^Fdw      , Hh^Fdw      , Re          , Hh^Fdw      , Gs^Fdw      
Gs^Fdw      , Gs^Fdw      , Gs^Fdw      , Gg          , Gg^Vo       , Gg          , Gs^Fdw      , Gs^Fdw      , Gs^Fdw      , Gg          , Ss          , Ss          , Gg          , Ss          , Ss^Vm       , Ww          , Ww          , Ww          , Ww          , Ww          , Gg          , Gg          , Re          , Re          , Re          , Re          , Hh^Fdw      , Gs^Fdw      
Gs^Fdw      , Gs^Fdw      , Gs^Fdw      , Gs^Fdw      , Gg          , Gs^Fdw      , Gs^Fdw      , Gs^Fdw      , Gg          , Gs^Fdw      , Ss          , Ss          , Ss          , Ss          , Ss          , Ww          , Ww          , Ww          , Ww          , Ss^Vhs      , Gg          , Gs^Fdw      , Re          , Hh^Fdw      , Gs^Fdw      , Hh^Fdw      , Hh^Fdw      , Hh^Fdw      
Gg          , Gg          , Gg          , Gs^Fdw      , Gs^Fdw      , Gs^Fdw      , Gg          , Gs^Fdw      , Gs^Fdw      , Gs^Fdw      , Gs^Fdw      , Ss          , Gg          , Gg          , Ss          , Ss          , Ww          , Ww          , Ww          , Ww          , Gg          , Re          , Hh^Fdw      , Hh^Fdw      , Hh^Fdw      , Hh^Fdw      , Gg          , Hh^Fdw      
Gs^Fdw      , Gs^Fdw      , Gg          , Gg          , Gs^Fdw      , Gs^Fdw      , Gs^Fdw      , Gs^Fdw      , Gs^Fdw      , Gg          , Ss          , Ss          , Ss          , Ss          , Ww          , Ww          , Ww          , Ww          , Ww          , Ss          , Ss          , Re          , Gg          , Gg          , Hh^Vo       , Hh^Fdw      , Gs^Fdw      , Hh^Fdw      
Gs^Fdw      , Gs^Fdw      , Gs^Fdw      , Gg          , Gs^Fdw      , Gs^Fdw      , Gs^Fdw      , Gs^Fdw      , Gg          , Gg          , Ss          , Ss^Vhs      , Ss          , Ss          , Ww          , Ww          , Wwf         , Ww          , Ww          , Ss          , Re          , Re          , Gg          , Gs^Fdw      , Gs^Fdw      , Gs^Fdw      , Gs^Fdw      , Gs^Fdw      
Gs^Fdw      , Gs^Fdw      , Gg          , Gg          , Gg^Vo       , Gs^Fdw      , Gs^Fdw      , Gg          , Gs^Fdw      , Gg          , Gg          , Ss          , Re          , Ss          , Re          , Wwf         , Wwf         , Wwf         , Wwf         , Re          , Gg          , Gg          , Gg          , Gg          , Gs^Fdw      , Gs^Fdw      , Gs^Fdw      , Gs^Fdw      
Gs^Fdw      , Gs^Fdw      , Gg          , Gg          , Ss          , Gg          , Gg          , Gs^Fdw      , Gg          , Gg          , Re          , Re          , Gg          , Re          , Ss          , Ww          , Wwf         , Ww          , Wwf         , Ww          , Ss          , Ss          , Gg          , Gg          , Gs^Fdw      , Gs^Fdw      , Gs^Fdw      , Gs^Fdw      
Gg          , Gg          , Gg          , Ss          , Gg          , Gg          , Re          , Re          , Re          , Re          , Gg          , Gg          , Gg          , Ss          , Ww          , Wwf         , Ww          , Ww          , Ww          , Gg          , Ss^Vhs      , Gg          , Gs^Fdw      , Gs^Fdw      , Gg          , Hh^Fdw      , Hh^Fdw      , Gg          
Gg          , Gg^Vo       , Gg          , Ss          , Gg          , Gs^Fdw      , Re          , Gg          , Gg          , Gg          , Ss          , Gg          , Ss          , Ss          , Ww          , Ww          , Ww          , Ww          , Ww          , Ww          , Ss          , Gg          , Gg          , Gs^Fdw      , Gs^Fdw      , Hh^Fdw      , Gs^Fdw      , Gg          
Gg          , Gs^Fdw      , Gs^Fdw      , Gg          , Gs^Fdw      , Gs^Fdw      , Gg          , Re          , Gg          , Ss          , Ss          , Ss          , Ss          , Ss          , Ss          , Ww          , Ww          , Ww          , Ww          , Ss          , Gg          , Ss          , Gs^Fdw      , Gs^Fdw      , Gs^Fdw      , Gg          , Gs^Fdw      , Gg          
Gs^Fdw      , Gg          , Chr         , Gg          , Gs^Fdw      , Gs^Fdw      , Gg          , Re          , Gg          , Gg          , Ss          , Gg          , Ss          , Ss          , Ww          , Ww          , Ss          , Ww          , Gg          , Ss          , Ss          , Gg          , Ss          , Gs^Fdw      , Gg          , Gg          , Hh^Fdw      , Hh^Fdw      
Gs^Fdw      , Chr         , 4 Khr       , Chr         , Gs^Fdw      , Gs^Fdw      , Re          , Re          , Gg          , Ss          , Gg          , Ss          , Ss^Vm       , Ss          , Ww          , Ww          , Ss^Vhs      , Ww          , Ss          , Gg          , Chs         , Chs         , Chs         , Gg          , Gg          , Gs^Fdw      , Gs^Fdw      , Hh^Fdw      
Gs^Fdw      , Chr         , Chr         , Chr         , Gs^Fdw      , Re          , Gg          , Gg^Vo       , Gg          , Ss          , Gg          , Ss          , Ss          , Ww          , Ww          , Ss          , Ww          , Ww          , Ss          , Ss          , Chs         , 3 Khs       , Chs         , Ss          , Gg          , Gs^Fdw      , Hh^Vo       , Hh^Fdw      
Gs^Fdw      , Gg          , Gs^Fdw      , Gs^Fdw      , Gs^Fdw      , Re          , Re          , Ss          , Gg          , Ss          , Ss          , Ss          , Ss          , Ww          , Ww          , Ww          , Ww          , Ss          , Ss^Vm       , Ww          , Gg          , Chs         , Ss          , Ss          , Gg          , Gs^Fdw      , Gs^Fdw      , Gs^Fdw      
Gs^Fdw      , Gs^Fdw      , Gs^Fdw      , Gs^Fdw      , Gs^Fdw      , Gs^Fdw      , Re          , Ss          , Gg          , Gg          , Ss          , Ss          , Ww          , Ww          , Ww          , Ss          , Ww          , Ww          , Ss          , Ss          , Ss          , Ss          , Ss          , Gg          , Gs^Fdw      , Gs^Fdw      , Gs^Fdw      , Gs^Fdw      
