border_size=1
usage=map

Wo          , Wo          , Wo          , Wo          , Wo          , Wo          , Wo          , Wo          , Wo          , Wo          , Wo          , Ww          , Wo          , Wo          , Ww          , Ww          , Ww          , Ds          , Ds          , Gg          , Gg          , Gg          , Gg          , Co          , Co          , Co          , Gg          , Gg          , Gs^Fp       , Gs^Fp       , Gs^Fp       , Gs^Fp       , Rd          , Gg          , Gg          , Gg          , Gg          , Gg          , Gg          , Gg          , Gs^Fp       , Gg          , Gg          , Gs^Fp       , Gs^Fp       , Gg^Vo       , Gs^Fp       
Ww          , Ww          , Ww^Vm       , Ww          , Ww          , Wo          , Wo          , Wo          , Wo          , Wo          , Wo          , Wo          , Wo          , Wo          , Ww          , Ww          , Ww          , Ww          , Ww^Bw/      , Ds          , Gg          , Gg          , Gg          , Co          , 2 Ko        , Co          , Gg          , Gg          , Gs^Fp       , Gs^Fp       , Gs^Fp       , Gs^Fp       , Rd          , Gs^Fp       , Gg          , Gg          , Gs^Fp       , Gg          , Gs^Fp       , Gg          , Gg          , Gs^Fp       , Gs^Fp       , Gs^Fp       , Gs^Fp       , Gs^Fp       , Rd          
Wo          , Ww          , Ww          , Ww          , Wo          , Wo          , Wo          , Wo          , Wo          , Wo          , Wo          , Wo          , Wo          , Wo          , Wo          , Ww          , Ww          , Ww          , Ww          , Ds          , Gg          , Gg^Vo       , Gg          , Co          , Co          , Co          , Gg          , Gg          , Gg          , Gs^Fp       , Gs^Fp       , Gg          , Rd          , Gs^Fp       , Gs^Fp       , Gs^Fp       , Gg          , Gg          , Gg          , Gs^Fp       , Gg          , Gs^Fp       , Rd          , Rd          , Rd          , Rd          , Gg          
Wo          , Wo          , Wo          , Ww          , Wo          , Wo          , Wo          , Wo          , Wo          , Wo          , Wo          , Wo          , Wo          , Wo          , Ww          , Ww          , Ww          , Ww          , Ww          , Ds          , Ds          , Gg          , Gg          , Co          , Gg          , Co          , Gg          , Gg          , Gg          , Gg^Vo       , Rd          , Rd          , Rd          , Gg          , Gg          , Gs^Fp       , Rd          , Gg^Vo       , Rd          , Gg          , Rd          , Rd          , Gg          , Gg          , Gg          , Gg          , Gg          
Wo          , Wo          , Wo          , Wo          , Wo          , Wo          , Wo          , Wo          , Wo          , Wo          , Wo          , Wo          , Wo          , Ww          , Ww          , Ww          , Ww          , Ww          , Ww          , Ds          , Ds          , Gg          , Gs^Fds      , Gg          , Gg          , Gg          , Gg          , Gg          , Rd          , Rd          , Gg          , Gg          , Gg          , Rd          , Rd          , Rd          , Gs^Fp       , Rd          , Gs^Fp       , Rd          , Gg          , Gg          , Gg          , Gg^Vo       , Gg          , Gs^Fp       , Gs^Fp       
Wo          , Wo          , Wo          , Wo          , Wo          , Wo          , Ww          , Wo          , Wo          , Wo          , Wo          , Wo          , Wo          , Ww          , Ww^Vm       , Ww          , Ww          , Ww          , Ww          , Ww^Bw/      , Ds          , Gg          , Gs^Fds      , Gs^Fds      , Gg          , Gg^Vo       , Gg          , Rd          , Gg          , Gs^Fp       , Gs^Fp       , Gs^Fp       , Gs^Fp       , Gg          , Rd          , Gg          , Gs^Fp       , Gs^Fp       , Gs^Fp       , Gg          , Gg          , Gg          , Co          , Gg          , Gg          , Gs^Fp       , Gs^Fp       
Wo          , Wo          , Wo          , Wo          , Ww          , Ww          , Ww          , Mm          , Wo          , Wo          , Wo          , Wo          , Wo          , Ww          , Ww          , Ww          , Ww          , Ww          , Ww          , Ww          , Ds          , Gg          , Gg          , Gg          , Gg          , Gg          , Rd          , Rd          , Gg          , Gs^Fp       , Gg          , Gg          , Gg          , Gg          , Rd          , Gg          , Gs^Fp       , Gg          , Gg          , Gg          , Gg          , Co          , 3 Ko        , Co          , Gg          , Gg          , Gg          
Wo          , Wo          , Wo          , Ww          , Ww          , Ww^Vm       , Ww          , Ww          , Wo          , Wo          , Wo          , Wo          , Wo          , Wo          , Wo          , Ww          , Ww          , Ww          , Ww          , Ds          , Gg          , Gg^Vo       , Rd          , Rd          , Rd          , Rd          , Rd          , Gg          , Gg          , Gg          , Gg          , Gg          , Gg          , Gg          , Rd          , Rd          , Rd          , Gg          , Gg          , Gg          , Gg          , Co          , Co          , Co          , Gg          , Gg^Vo       , Gs^Fp       
Wo          , Wo          , Wo          , Wo          , Ww          , Ww          , Wo          , Wo          , Wo          , Wo          , Wo          , Wo          , Wo          , Wo          , Wo          , Ww          , Ww          , Ww          , Ww          , Ds          , Gg          , Rd          , Gs^Fds      , Gs^Fds      , Gs^Fds      , Gs^Fds      , Rd          , Gg          , Gg          , Gg          , Gg          , Ss          , Gg          , Ss          , Rd          , Gg^Vo       , Gg          , Rd          , Rd          , Gg          , Gg          , Gg          , Gg          , Gg          , Gs^Fp       , Gs^Fp       , Gs^Fp       
Wo          , Wo          , Wo          , Wo          , Ww          , Wo          , Wo          , Wo          , Wo          , Wo          , Wo          , Wo          , Wo          , Wo          , Wo          , Wo          , Ww          , Ww          , Ww          , Gs^Fds      , Gg          , Rd          , Co          , Gs^Fds      , Gs^Fds      , Gs^Fds      , Rd          , Gg          , Ss          , Gg          , Gg          , Gg          , Gg          , Ss          , Rd          , Gg          , Gs^Fds      , Gg          , Gg          , Rd          , Rd          , Gg          , Gg          , Gg          , Gg          , Gs^Fp       , Gs^Fp       
Wo          , Wo          , Ww          , Ww          , Ww          , Wo          , Wo          , Wo          , Wo          , Wo          , Wo          , Wo          , Wo          , Wo          , Wo          , Wo          , Ww          , Ww          , Ww          , Ww          , Ww          , Ww          , Ww          , Gg          , Gg          , Rd          , Ss          , Ss          , Ss          , Ss          , Gg          , Co          , Gg          , Gg          , Rd          , Gs^Fds      , Gs^Fds      , Co          , Gs^Fds      , Gg          , Rd          , Ss          , Ss          , Gg          , Gg          , Gg^Vo       , Gg          
Wo          , Wo          , Ww          , Ww          , Ww          , Ww          , Ww          , Ww          , Ww          , Ww          , Ww          , Wo          , Wo          , Wo          , Wo          , Wo          , Ww          , Ww          , Ww          , Ww          , Ww          , Ww          , Ww          , Ww          , Ww          , Ww^Bw|      , Ww          , Ss^Vm       , Ss          , Ss          , Ss          , Gg          , Ss          , Gg          , Rd          , Gs^Fds      , Gs^Fds      , Gg          , Gs^Fds      , Gg          , Gg^Vo       , Rd          , Rd          , Gg          , Gg          , Gg          , Gg          
Wo          , Wo          , Wo          , Ww          , Ww          , Ww          , Ww          , Ww          , Ww          , Ww^Vm       , Ww          , Ww          , Wo          , Wo          , Wo          , Wo          , Ww          , Ww          , Ww          , Gg          , Gg          , Ss          , Ss          , Ww          , Ww          , Ww^Bw|      , Ww          , Ww          , Ss          , Ss          , Ss          , Ss          , Gg          , Ss          , Rd          , Ss          , Ss          , Ss          , Ss          , Gs^Fds      , Gg          , Gg          , Rd          , Co          , Gg          , Gg          , Gg          
Wo          , Wo          , Ww          , Ww          , Ww          , Ww          , Ww          , Ww          , Ww          , Ww          , Ww          , Wo          , Wo          , Wo          , Wo          , Wo          , Wo          , Ww          , Ww^Bw/      , Ds          , Gg          , Gg^Vo       , Ss          , Ss          , Gg          , Gg          , Ss          , Ww          , Ww          , Ss          , Ww          , Ww          , Ww          , Ss          , Rd          , Ss          , Ww          , Ss          , Ss          , Ss          , Gs^Fds      , Gg          , Rd          , Gg          , Ss          , Ss          , Ss          
Ww          , Ww          , Ww          , Ww          , Ww          , Ww          , Ww          , Ww          , Wo          , Ww          , Wo          , Wo          , Wo          , Wo          , Wo          , Wo          , Wo          , Ww          , Ww          , Ww          , Gg          , Gg          , Gg          , Gg          , Ww          , Ww          , Ww          , Ww          , Ww          , Ww          , Ww          , Ww          , Ww          , Ww          , Ww^Bw|      , Ww          , Ss          , Ww          , Ss          , Ss          , Rd          , Ss          , Rd          , Gg          , Ss          , Ss^Vm       , Ss          
Wo          , Ww          , Ww          , Ww          , Ww          , Ww          , Ww          , Ww          , Ww          , Wo          , Wo          , Ww          , Wo          , Wo          , Wo          , Wo          , Wo          , Ww          , Ww          , Ww          , Ww          , Ss          , Ww          , Ww^Bw|      , Ww          , Ww          , Ss          , Gg          , Gg          , Ss          , Ss          , Ss          , Ss          , Ss          , Rd          , Ss          , Ss          , Ww          , Ww^Bw/      , Rd          , Ss          , Rd          , Rd          , Ss          , Gg          , Ss          , Gg          
Wo          , Wo          , Ww          , Ww          , Ww          , Ww          , Ww          , Ww          , Ww          , Wo          , Wo          , Wo          , Wo          , Wo          , Ww          , Wo          , Ww          , Ww          , Ww          , Ww          , Ww          , Ww          , Ww          , Ww^Bw|      , Ss          , Ss          , Gg          , Gg          , Gg          , Ss          , Ss^Vm       , Ss          , Ss          , Rd          , Ss          , Ss          , Ss          , Rd          , Ss          , Ww          , Ss          , Ss          , Rd          , Gg          , Gg          , Gg          , Gg          
Wo          , Wo          , Ww          , Ww          , Chw         , Ww          , Ww          , Ww          , Ww          , Wo          , Wo          , Wo          , Ww          , Ww          , Ww          , Wo          , Ww          , Ww          , Ww          , Ww          , Ww          , Ww          , Gg          , Rd          , Gg          , Gg          , Gg^Vo       , Gg          , Gs^Fds      , Ss          , Ss          , Ss          , Ss          , Rd          , Ss          , Ss^Vm       , Rd          , Rd          , Ss          , Ww          , Gg          , Rd          , Gg          , Rd          , Gg          , Ss          , Gg          
Wo          , Wo          , Ww          , Ww          , 4 Khw       , Ww          , Ww          , Ww          , Ww          , Wo          , Wo          , Wo          , Ww          , Ww^Vm       , Wo          , Wo          , Ww          , Ww          , Ww          , Ww          , Gg          , Gg          , Gg          , Rd          , Rd          , Gg          , Gg          , Gs^Fds      , Gg          , Gs^Fds      , Gs^Fds      , Ss          , Rd          , Rd          , Rd          , Rd          , Ss          , Ss          , Ss          , Ww          , Ww^Bw/      , Rd          , Ss          , Rd          , Ss          , Co          , Ss          
Wo          , Wo          , Ww          , Chw         , Ww          , Chw         , Ww          , Ww          , Ww          , Wo          , Wo          , Wo          , Wo          , Ww          , Wo          , Wo          , Ww          , Ww          , Ww^Bw/      , Ds          , Ds          , Gg          , Gg          , Gg          , Gg          , Rd          , Rd          , Gs^Fds      , Gg          , Gg          , Gg          , Rd          , Ss          , Ss          , Gg          , Ss          , Ss          , Ss          , Rd          , Rd          , Ss          , Ww          , Ww^Bw/      , Rd          , Ss          , Ss^Vm       , Ss          
Wo          , Wo          , Ww          , Ww          , Ww          , Ww          , Ww          , Ww          , Ww          , Wo          , Wo          , Wo          , Wo          , Wo          , Wo          , Ww          , Ww          , Ww          , Ww          , Ww          , Ds          , Gg          , Gg^Vo       , Gg          , Ss          , Gg          , Ss          , Rd          , Rd          , Gg          , Gg          , Rd          , Gs^Fds      , Gs^Fds      , Gs^Fds      , Ss          , Ss          , Ss          , Rd          , Ss          , Rd          , Rd          , Gg          , Ww          , Ww          , Ss          , Ss          
Wo          , Ww          , Ww          , Ww          , Ww          , Ww          , Wo          , Wo          , Wo          , Wo          , Wo          , Wo          , Wo          , Ww          , Wo          , Ww          , Ww          , Ww          , Ww          , Ww^Bw/      , Ds          , Gg          , Gg          , Gg          , Gg          , Ss          , Gg          , Gg          , Rd          , Gg          , Gg          , Rd          , Gg          , Gg^Vo       , Gs^Fds      , Gs^Fds      , Rd          , Rd          , Ss          , Rd          , Ss          , Ss          , Ss          , Gg          , Ss          , Ww          , Ww^Bw/      
Wo          , Wo          , Wo          , Ww          , Ww          , Ww          , Ww          , Wo          , Wo          , Wo          , Wo          , Wo          , Wo          , Ww          , Wo          , Wo          , Ww          , Ww          , Ww          , Ww          , Ds          , Gg          , Gg          , Gg          , Gg          , Gg          , Gg^Vo       , Gg          , Rd          , Rd          , Rd          , Rd          , Gg          , Gs^Fds      , Rd          , Rd          , Gg          , Ss          , Ss          , Ss          , Ss^Vm       , Ss          , Gs^Fds      , Ss          , Ss          , Ss          , Ss          
Wo          , Wo          , Wo          , Wo          , Ww          , Ww          , Ww^Vm       , Ww          , Ww          , Wo          , Wo          , Wo          , Wo          , Wo          , Wo          , Wo          , Wo          , Ww          , Ww          , Ww          , Ds          , Gg          , Gg          , Gg          , Gg          , Gg          , Gg          , Gg          , Rd          , Gs^Fp       , Gs^Fp       , Rd          , Rd          , Rd          , Gg          , Rd          , Gg          , Gg          , Gs^Fds      , Ss          , Ss          , Ss          , Ss          , Ss          , Ss          , Ss          , Gg          
Wo          , Wo          , Wo          , Wo          , Wo          , Ww          , Ww          , Ww          , Ww          , Ww          , Ww          , Wo          , Wo          , Wo          , Wo          , Wo          , Wo          , Ww          , Ww          , Ww          , Ds          , Gg          , Gg          , Gg          , Gg          , Gg          , Rd          , Rd          , Gs^Fp       , Gg          , Gs^Fp       , Gg          , Gg          , Gg          , Gg          , Rd          , Rd          , Gg          , Rd          , Gg          , Gs^Fds      , Ss          , Gg^Vo       , Gs^Fds      , Gs^Fds      , Gs^Fds      , Gs^Fds      
Wo          , Wo          , Wo          , Wo          , Wo          , Wo          , Wo          , Wo          , Wo          , Wo          , Wo          , Wo          , Wo          , Wo          , Wo          , Wo          , Wo          , Ww          , Ww          , Ww          , Ds          , Gg          , Gg          , Gg          , Gg          , Gg          , Rd          , Gg          , Gg          , Gg          , Gs^Fp       , Gs^Fp       , Gs^Fp       , Gg          , Gs^Fp       , Gg          , Rd          , Rd          , Gs^Fp       , Rd          , Rd          , Gs^Fds      , Rd          , Gs^Fds      , Rd          , Gs^Fds      , Gs^Fds      
Wo          , Wo          , Ww          , Wo          , Ww          , Wo          , Wo          , Wo          , Wo          , Wo          , Wo          , Wo          , Ww          , Ww          , Ww          , Wo          , Wo          , Ww          , Ww          , Ww          , Ds          , Gg          , Gg          , Gg          , Rd          , Rd          , Gg^Vo       , Gg          , Gg          , Gg          , Gs^Fp       , Gs^Fp       , Gg          , Gs^Fp       , Gg          , Gg          , Rd          , Gs^Fp       , Gs^Fp       , Gs^Fp       , Gg          , Rd          , Gg          , Rd          , Ce          , Rd          , Rd          
Ww          , Ww          , Ww^Vm       , Ww          , Ww          , Wo          , Wo          , Wo          , Wo          , Wo          , Wo          , Wo          , Ww          , Ww^Vm       , Ww          , Ww          , Wo          , Ww          , Ww          , Ww          , Ds          , Gg          , Gg          , Gg          , Rd          , Gg          , Gg          , Gg          , Gs^Fp       , Gg          , Gg          , Gs^Fp       , Gs^Fp       , Gg          , Gg^Vo       , Gg          , Gg          , Rd          , Rd          , Gs^Fp       , Gs^Fp       , Gg          , Gg          , Ce          , 1 Ke        , Ce          , Gs^Fp       
Wo          , Ww          , Wo          , Ww          , Wo          , Wo          , Wo          , Wo          , Wo          , Wo          , Wo          , Wo          , Wo          , Ww          , Wo          , Wo          , Ww          , Ww          , Ww          , Ww^Bw/      , Ds          , Gg          , Gg^Vo       , Gg          , Rd          , Gg          , Gg          , Gs^Fp       , Gg          , Gs^Fp       , Gg^Vo       , Gg          , Gg          , Gg          , Gg          , Gs^Fp       , Gs^Fp       , Gs^Fp       , Rd          , Gs^Fp       , Gs^Fp       , Gs^Fp       , Gs^Fp       , Ce          , Ce          , Ce          , Gs^Fp       
Ww          , Wo          , Wo          , Wo          , Wo          , Wo          , Wo          , Wo          , Wo          , Wo          , Wo          , Wo          , Ww          , Wo          , Ww          , Wo          , Ww          , Ww          , Ww          , Ww          , Ds          , Ds          , Gg          , Rd          , Gg          , Gs^Fp       , Gg          , Gs^Fp       , Gg          , Gs^Fp       , Gg          , Gg          , Gg          , Gg          , Gg          , Gs^Fp       , Gs^Fp       , Gs^Fp       , Rd          , Gs^Fp       , Gg          , Gs^Fp       , Gg          , Gs^Fp       , Gg          , Gs^Fp       , Gs^Fp       
