border_size=1
usage=map

Mm^Vhh      , Ms          , Mm          , Mm          , Mm          , Mm          , Mm          , Mm          , Mm          , Mm          , Mm          , Mm          , Mm          , Mm          , Mm^Vhh      , Mm          , Mm          , Ww          , Mm          , Mm          , Mm          , Mm          , Mm          , Mm          , Mm          , Mm          
Mm          , Mm          , Mm          , Mm          , Mm          , Mm          , Mm          , Mm          , Mm          , Mm          , Hh^Fms      , Mm          , Hh^Fms      , Mm          , Mm          , Mm          , Hh^Fms      , Ww          , Ww          , Hh^Fds      , Hh^Fds      , Mm          , Hh^Fds      , Mm          , Hh^Fds      , Mm          
Hh          , Mm          , Hh          , Hh          , Hh          , Hh^Fds      , Hh^Fds      , Hh^Fds      , Hh^Fms      , Hh^Fms      , Ww          , Ww          , Ww          , Ww          , Ww          , Ww          , Ww          , Gg          , Gs^Fds      , Ww          , Ww          , Hh^Fds      , Hh^Fds      , Hh^Fds      , Hh^Fp       , Hh^Fds      
Hh^Fdw      , Hh^Fds      , Hh^Fds      , Hh^Fds      , Hh          , Hh          , Gg          , Gg          , Ww          , Ww          , Ch          , Ch          , Ch          , Ch          , Ch          , Ch          , Ch          , Ww          , Ww          , Gg          , Ww          , Hh^Fds      , Gs^Fp       , Hh^Fp       , Hh^Fp       , Hh^Fp       
Gg          , Gg          , Gg          , Gg          , Gg          , Gg          , Ww          , Ww          , Ch          , Ch          , Rr          , Rr          , Rr          , Rp^Vhc      , Rp          , Rr          , Rp          , Ch          , Ch          , Ww          , Ww          , Gs^Fp       , Hh^Fdf      , Hh^Fp       , Hh^Fp       , Hh^Fp       
Gg          , Gg          , Gg          , Gg          , Gg          , Gg          , Ww          , Ch          , Rr          , Rr          , Rr          , Rp          , Ch          , Rp          , Ch          , Rp          , Rp          , Rp^Vhc      , Rp          , Ch          , Ww^Bw\      , Gs^Fp       , Rr          , Rr          , Rr          , Rr          
Gg^Vh       , Gg          , Gg          , Gg          , Gg          , Gg          , Ww^Bw/      , Ch          , Rr          , Rp^Vhc      , Rp          , Ch          , Rp^Vhc      , Ch          , Rp^Vhc      , Ch          , Rp          , Rp          , Rp          , Ch          , Ww^Bw\      , Rr          , Rr          , Rr          , Rr          , Rr          
Rp          , Rp          , Rp          , Rp          , Rp          , Rp          , Ww^Bw/      , Ch          , Rr          , Rr          , Rp          , Ch          , Rp^Vhc      , 1 Kh        , Rp^Vhc      , Ch          , Rp          , Rp^Vhc      , Rp          , Ch          , Ww^Bw\      , Rr          , Rr          , Rr          , Rr          , Rr          
Rp          , Rp          , Gg          , Rp          , Gg          , Rp          , Ww          , Ch          , Rr          , Rp^Vhc      , Rp          , Ch          , Ch          , 2 Ch        , Ch          , Ch          , Rp          , Rp          , Rp          , Ch          , Ww          , Rp          , Hh^Fp       , Rr          , Hh^Fp       , Rr          
Gg          , Gg          , Gg          , Gg          , Hh^Fds      , Gg          , Ww          , Ch          , Ch          , Rp          , Rp          , Rp          , Rp          , Rp          , Rp          , Rp          , Rp          , Rp          , Ch          , Ch          , Ww          , Gg          , Hh^Fp       , Hh^Fp       , Hh^Fms      , Hh^Fp       
Gg          , Gg          , Hh^Fds      , Hh^Fds      , Hh^Fds      , Gg          , Gg         , Ww          , Ww          , Ch          , Ch          , Rp          , Ch          , Rp^Vhc      , Ch          , Rp          , Ch          , Ch          , Ww          , Ww          , Gg          , Gg          , Hh^Fms      , Hh^Fms      , Hh^Fms      , Hh^Fp       
Gg          , Hh^Fds      , Mm          , Hh^Fds      , Hh^Fds      , Hh^Fds      , Gg          , Gg          , Gg          , Ww          , Ww          , Ch          , Ww^Bw|      , Ch          , Ww^Bw|      , Ch          , Ww          , Ww          , Gg          , Gg          , Gg          , Gg          , Gg          , Hh^Fms      , Hh^Fms      , Hh^Fms      
Gg          , Hh^Fds      , Hh^Fds      , Mm          , Hh^Fds      , Gg          , Gg          , Gg          , Gg          , Gg          , Gg         , Ww          , Rr          , Ww^Bw|      , Rr          , Ww          , Gg          , Gg          , Gg          , Gg          , Gg          , Gg          , Gg          , Hh^Fms      , Hh^Fms      , Mm          
Gg          , Hh^Fds      , Hh^Fds      , Mm          , Hh^Fds      , Hh^Fds      , Gg          , Gg          , Gg          , Gg          , Gg          , Gg         , Rr          , Rr          , Rr          , Gg          , Gg          , Gg          , Gg          , Gg          , Gg          , Ch          , Hh^Fms      , Hh^Fms      , Hh^Fp       , Mm          
